PokerStars Hand #201884707136: Tournament #2634449693, $0.98+$0.12 USD Hold'em No Limit - Level IX (800/1600) - 2019/06/30 17:03:14 BRT [2019/06/30 16:03:14 ET]
Table '2634449693 122' 9-max Seat #1 is the button
Seat 1: Jair Filho (51745 in chips) 
Seat 2: Wolks09 (96720 in chips) 
Seat 3: R.Sarquis (73255 in chips) 
Seat 4: makrem81 (92440 in chips) 
Seat 5: DaveGregaz (49760 in chips) 
Seat 6: AlyCWB (50000 in chips) 
Seat 7: zoologikos (49760 in chips) 
Seat 8: Sempre Nessa (80858 in chips) 
Seat 9: IgorMcgregor (40566 in chips) 
Jair Filho: posts the ante 160
Wolks09: posts the ante 160
R.Sarquis: posts the ante 160
makrem81: posts the ante 160
DaveGregaz: posts the ante 160
AlyCWB: posts the ante 160
zoologikos: posts the ante 160
Sempre Nessa: posts the ante 160
IgorMcgregor: posts the ante 160
Wolks09: posts small blind 800
R.Sarquis: posts big blind 1600
*** HOLE CARDS ***
Dealt to AlyCWB [3h 8c]
makrem81: folds 
DaveGregaz: folds 
AlyCWB: folds 
zoologikos: raises 2274 to 3874
Sempre Nessa: folds 
IgorMcgregor: folds 
Jair Filho: folds 
Wolks09: folds 
R.Sarquis: calls 2274
*** FLOP *** [Tc 2d 7h]
R.Sarquis: checks 
zoologikos: checks 
*** TURN *** [Tc 2d 7h] [6c]
R.Sarquis: bets 3296
zoologikos: folds 
Uncalled bet (3296) returned to R.Sarquis
R.Sarquis collected 9988 from pot
*** SUMMARY ***
Total pot 9988 | Rake 0 
Board [Tc 2d 7h 6c]
Seat 1: Jair Filho (button) folded before Flop (didn't bet)
Seat 2: Wolks09 (small blind) folded before Flop
Seat 3: R.Sarquis (big blind) collected (9988)
Seat 4: makrem81 folded before Flop (didn't bet)
Seat 5: DaveGregaz folded before Flop (didn't bet)
Seat 6: AlyCWB folded before Flop (didn't bet)
Seat 7: zoologikos folded on the Turn
Seat 8: Sempre Nessa folded before Flop (didn't bet)
Seat 9: IgorMcgregor folded before Flop (didn't bet)



PokerStars Hand #201884746763: Tournament #2634449693, $0.98+$0.12 USD Hold'em No Limit - Level IX (800/1600) - 2019/06/30 17:04:11 BRT [2019/06/30 16:04:11 ET]
Table '2634449693 122' 9-max Seat #2 is the button
Seat 1: Jair Filho (51585 in chips) 
Seat 2: Wolks09 (95760 in chips) 
Seat 3: R.Sarquis (79209 in chips) 
Seat 4: makrem81 (92280 in chips) 
Seat 5: DaveGregaz (49600 in chips) 
Seat 6: AlyCWB (49840 in chips) 
Seat 7: zoologikos (45726 in chips) 
Seat 8: Sempre Nessa (80698 in chips) 
Seat 9: IgorMcgregor (40406 in chips) 
Jair Filho: posts the ante 160
Wolks09: posts the ante 160
R.Sarquis: posts the ante 160
makrem81: posts the ante 160
DaveGregaz: posts the ante 160
AlyCWB: posts the ante 160
zoologikos: posts the ante 160
Sempre Nessa: posts the ante 160
IgorMcgregor: posts the ante 160
R.Sarquis: posts small blind 800
makrem81: posts big blind 1600
*** HOLE CARDS ***
Dealt to AlyCWB [Js Ac]
DaveGregaz: folds 
AlyCWB: raises 3200 to 4800
zoologikos: folds 
Sempre Nessa: folds 
IgorMcgregor: folds 
Jair Filho: calls 4800
Wolks09: folds 
R.Sarquis: folds 
makrem81: calls 3200
*** FLOP *** [Tc 8s 9h]
makrem81: checks 
AlyCWB: checks 
Jair Filho: bets 5491
makrem81: folds 
AlyCWB: calls 5491
*** TURN *** [Tc 8s 9h] [3s]
AlyCWB: checks 
Jair Filho: bets 9115
AlyCWB: calls 9115
*** RIVER *** [Tc 8s 9h 3s] [Ad]
AlyCWB: checks 
Jair Filho: checks 
*** SHOW DOWN ***
AlyCWB: shows [Js Ac] (a pair of Aces)
Jair Filho: mucks hand 
AlyCWB collected 45852 from pot
*** SUMMARY ***
Total pot 45852 | Rake 0 
Board [Tc 8s 9h 3s Ad]
Seat 1: Jair Filho mucked [Jh 8h]
Seat 2: Wolks09 (button) folded before Flop (didn't bet)
Seat 3: R.Sarquis (small blind) folded before Flop
Seat 4: makrem81 (big blind) folded on the Flop
Seat 5: DaveGregaz folded before Flop (didn't bet)
Seat 6: AlyCWB showed [Js Ac] and won (45852) with a pair of Aces
Seat 7: zoologikos folded before Flop (didn't bet)
Seat 8: Sempre Nessa folded before Flop (didn't bet)
Seat 9: IgorMcgregor folded before Flop (didn't bet)



PokerStars Hand #201884811183: Tournament #2634449693, $0.98+$0.12 USD Hold'em No Limit - Level IX (800/1600) - 2019/06/30 17:05:44 BRT [2019/06/30 16:05:44 ET]
Table '2634449693 122' 9-max Seat #3 is the button
Seat 1: Jair Filho (32019 in chips) 
Seat 2: Wolks09 (95600 in chips) 
Seat 3: R.Sarquis (78249 in chips) 
Seat 4: makrem81 (87320 in chips) 
Seat 5: DaveGregaz (49440 in chips) 
Seat 6: AlyCWB (76126 in chips) 
Seat 7: zoologikos (45566 in chips) 
Seat 8: Sempre Nessa (80538 in chips) 
Seat 9: IgorMcgregor (40246 in chips) 
Jair Filho: posts the ante 160
Wolks09: posts the ante 160
R.Sarquis: posts the ante 160
makrem81: posts the ante 160
DaveGregaz: posts the ante 160
AlyCWB: posts the ante 160
zoologikos: posts the ante 160
Sempre Nessa: posts the ante 160
IgorMcgregor: posts the ante 160
makrem81: posts small blind 800
DaveGregaz: posts big blind 1600
*** HOLE CARDS ***
Dealt to AlyCWB [Kc Ah]
AlyCWB: raises 3200 to 4800
zoologikos: folds 
Sempre Nessa: folds 
IgorMcgregor: folds 
Jair Filho: raises 27059 to 31859 and is all-in
Wolks09: folds 
R.Sarquis: folds 
makrem81: folds 
DaveGregaz: folds 
AlyCWB: calls 27059
*** FLOP *** [7h Ac Td]
*** TURN *** [7h Ac Td] [7d]
*** RIVER *** [7h Ac Td 7d] [5c]
*** SHOW DOWN ***
AlyCWB: shows [Kc Ah] (two pair, Aces and Sevens)
Jair Filho: shows [Qd 9c] (a pair of Sevens)
AlyCWB collected 67558 from pot
Jair Filho finished the tournament
*** SUMMARY ***
Total pot 67558 | Rake 0 
Board [7h Ac Td 7d 5c]
Seat 1: Jair Filho showed [Qd 9c] and lost with a pair of Sevens
Seat 2: Wolks09 folded before Flop (didn't bet)
Seat 3: R.Sarquis (button) folded before Flop (didn't bet)
Seat 4: makrem81 (small blind) folded before Flop
Seat 5: DaveGregaz (big blind) folded before Flop
Seat 6: AlyCWB showed [Kc Ah] and won (67558) with two pair, Aces and Sevens
Seat 7: zoologikos folded before Flop (didn't bet)
Seat 8: Sempre Nessa folded before Flop (didn't bet)
Seat 9: IgorMcgregor folded before Flop (didn't bet)



PokerStars Hand #201884837971: Tournament #2634449693, $0.98+$0.12 USD Hold'em No Limit - Level IX (800/1600) - 2019/06/30 17:06:22 BRT [2019/06/30 16:06:22 ET]
Table '2634449693 122' 9-max Seat #4 is the button
Seat 2: Wolks09 (95440 in chips) 
Seat 3: R.Sarquis (78089 in chips) 
Seat 4: makrem81 (86360 in chips) 
Seat 5: DaveGregaz (47680 in chips) 
Seat 6: AlyCWB (111665 in chips) 
Seat 7: zoologikos (45406 in chips) 
Seat 8: Sempre Nessa (80378 in chips) 
Seat 9: IgorMcgregor (40086 in chips) 
Wolks09: posts the ante 160
R.Sarquis: posts the ante 160
makrem81: posts the ante 160
DaveGregaz: posts the ante 160
AlyCWB: posts the ante 160
zoologikos: posts the ante 160
Sempre Nessa: posts the ante 160
IgorMcgregor: posts the ante 160
DaveGregaz: posts small blind 800
AlyCWB: posts big blind 1600
*** HOLE CARDS ***
Dealt to AlyCWB [5c 5s]
zoologikos: folds 
Sempre Nessa: folds 
IgorMcgregor: folds 
Wolks09: folds 
R.Sarquis: raises 1600 to 3200
makrem81: calls 3200
DaveGregaz: folds 
AlyCWB: calls 1600
*** FLOP *** [9s Qd Kc]
AlyCWB: checks 
R.Sarquis: bets 3854
makrem81: calls 3854
AlyCWB: folds 
*** TURN *** [9s Qd Kc] [6h]
R.Sarquis: bets 6398
makrem81: folds 
Uncalled bet (6398) returned to R.Sarquis
R.Sarquis collected 19388 from pot
*** SUMMARY ***
Total pot 19388 | Rake 0 
Board [9s Qd Kc 6h]
Seat 2: Wolks09 folded before Flop (didn't bet)
Seat 3: R.Sarquis collected (19388)
Seat 4: makrem81 (button) folded on the Turn
Seat 5: DaveGregaz (small blind) folded before Flop
Seat 6: AlyCWB (big blind) folded on the Flop
Seat 7: zoologikos folded before Flop (didn't bet)
Seat 8: Sempre Nessa folded before Flop (didn't bet)
Seat 9: IgorMcgregor folded before Flop (didn't bet)



PokerStars Hand #201884902466: Tournament #2634449693, $0.98+$0.12 USD Hold'em No Limit - Level IX (800/1600) - 2019/06/30 17:07:54 BRT [2019/06/30 16:07:54 ET]
Table '2634449693 122' 9-max Seat #5 is the button
Seat 1: mrmajestic68 (50000 in chips) 
Seat 2: Wolks09 (95280 in chips) 
Seat 3: R.Sarquis (90263 in chips) 
Seat 4: makrem81 (79146 in chips) 
Seat 5: DaveGregaz (46720 in chips) 
Seat 6: AlyCWB (108305 in chips) 
Seat 7: zoologikos (45246 in chips) 
Seat 8: Sempre Nessa (80218 in chips) 
Seat 9: IgorMcgregor (39926 in chips) 
mrmajestic68: posts the ante 160
Wolks09: posts the ante 160
R.Sarquis: posts the ante 160
makrem81: posts the ante 160
DaveGregaz: posts the ante 160
AlyCWB: posts the ante 160
zoologikos: posts the ante 160
Sempre Nessa: posts the ante 160
IgorMcgregor: posts the ante 160
AlyCWB: posts small blind 800
zoologikos: posts big blind 1600
*** HOLE CARDS ***
Dealt to AlyCWB [4h Ad]
Sempre Nessa: folds 
IgorMcgregor: folds 
mrmajestic68: folds 
Wolks09: folds 
R.Sarquis: raises 1760 to 3360
makrem81: calls 3360
DaveGregaz: folds 
AlyCWB: folds 
zoologikos: folds 
*** FLOP *** [6h 6s 7h]
R.Sarquis: checks 
makrem81: checks 
*** TURN *** [6h 6s 7h] [8c]
R.Sarquis: checks 
makrem81: bets 1600
R.Sarquis: folds 
Uncalled bet (1600) returned to makrem81
makrem81 collected 10560 from pot
makrem81: doesn't show hand 
*** SUMMARY ***
Total pot 10560 | Rake 0 
Board [6h 6s 7h 8c]
Seat 1: mrmajestic68 folded before Flop (didn't bet)
Seat 2: Wolks09 folded before Flop (didn't bet)
Seat 3: R.Sarquis folded on the Turn
Seat 4: makrem81 collected (10560)
Seat 5: DaveGregaz (button) folded before Flop (didn't bet)
Seat 6: AlyCWB (small blind) folded before Flop
Seat 7: zoologikos (big blind) folded before Flop
Seat 8: Sempre Nessa folded before Flop (didn't bet)
Seat 9: IgorMcgregor folded before Flop (didn't bet)



PokerStars Hand #201884934830: Tournament #2634449693, $0.98+$0.12 USD Hold'em No Limit - Level X (1000/2000) - 2019/06/30 17:08:40 BRT [2019/06/30 16:08:40 ET]
Table '2634449693 122' 9-max Seat #6 is the button
Seat 1: mrmajestic68 (49840 in chips) 
Seat 2: Wolks09 (95120 in chips) 
Seat 3: R.Sarquis (86743 in chips) 
Seat 4: makrem81 (86186 in chips) 
Seat 5: DaveGregaz (46560 in chips) 
Seat 6: AlyCWB (107345 in chips) 
Seat 7: zoologikos (43486 in chips) 
Seat 8: Sempre Nessa (80058 in chips) 
Seat 9: IgorMcgregor (39766 in chips) 
mrmajestic68: posts the ante 200
Wolks09: posts the ante 200
R.Sarquis: posts the ante 200
makrem81: posts the ante 200
DaveGregaz: posts the ante 200
AlyCWB: posts the ante 200
zoologikos: posts the ante 200
Sempre Nessa: posts the ante 200
IgorMcgregor: posts the ante 200
zoologikos: posts small blind 1000
Sempre Nessa: posts big blind 2000
*** HOLE CARDS ***
Dealt to AlyCWB [3d Ks]
IgorMcgregor: folds 
mrmajestic68: folds 
Wolks09: folds 
R.Sarquis: folds 
makrem81: folds 
DaveGregaz: folds 
AlyCWB: folds 
zoologikos: calls 1000
Sempre Nessa: checks 
*** FLOP *** [6s 7h Qd]
zoologikos: checks 
Sempre Nessa: checks 
*** TURN *** [6s 7h Qd] [3h]
zoologikos: checks 
Sempre Nessa: checks 
*** RIVER *** [6s 7h Qd 3h] [Qs]
zoologikos: checks 
Sempre Nessa: checks 
*** SHOW DOWN ***
zoologikos: shows [Td 5d] (a pair of Queens)
Sempre Nessa: shows [2s 3c] (two pair, Queens and Threes)
Sempre Nessa collected 5800 from pot
*** SUMMARY ***
Total pot 5800 | Rake 0 
Board [6s 7h Qd 3h Qs]
Seat 1: mrmajestic68 folded before Flop (didn't bet)
Seat 2: Wolks09 folded before Flop (didn't bet)
Seat 3: R.Sarquis folded before Flop (didn't bet)
Seat 4: makrem81 folded before Flop (didn't bet)
Seat 5: DaveGregaz folded before Flop (didn't bet)
Seat 6: AlyCWB (button) folded before Flop (didn't bet)
Seat 7: zoologikos (small blind) showed [Td 5d] and lost with a pair of Queens
Seat 8: Sempre Nessa (big blind) showed [2s 3c] and won (5800) with two pair, Queens and Threes
Seat 9: IgorMcgregor folded before Flop (didn't bet)



PokerStars Hand #201885000186: Tournament #2634449693, $0.98+$0.12 USD Hold'em No Limit - Level X (1000/2000) - 2019/06/30 17:10:13 BRT [2019/06/30 16:10:13 ET]
Table '2634449693 122' 9-max Seat #7 is the button
Seat 1: mrmajestic68 (49640 in chips) 
Seat 2: Wolks09 (94920 in chips) 
Seat 3: R.Sarquis (86543 in chips) 
Seat 4: makrem81 (85986 in chips) 
Seat 5: DaveGregaz (46360 in chips) 
Seat 6: AlyCWB (107145 in chips) 
Seat 7: zoologikos (41286 in chips) 
Seat 8: Sempre Nessa (83658 in chips) 
Seat 9: IgorMcgregor (39566 in chips) 
mrmajestic68: posts the ante 200
Wolks09: posts the ante 200
R.Sarquis: posts the ante 200
makrem81: posts the ante 200
DaveGregaz: posts the ante 200
AlyCWB: posts the ante 200
zoologikos: posts the ante 200
Sempre Nessa: posts the ante 200
IgorMcgregor: posts the ante 200
Sempre Nessa: posts small blind 1000
IgorMcgregor: posts big blind 2000
*** HOLE CARDS ***
Dealt to AlyCWB [3d Ks]
mrmajestic68: raises 4000 to 6000
Wolks09: folds 
R.Sarquis: folds 
makrem81: folds 
DaveGregaz: folds 
AlyCWB: folds 
zoologikos: folds 
Sempre Nessa: folds 
IgorMcgregor: folds 
Uncalled bet (4000) returned to mrmajestic68
mrmajestic68 collected 6800 from pot
*** SUMMARY ***
Total pot 6800 | Rake 0 
Seat 1: mrmajestic68 collected (6800)
Seat 2: Wolks09 folded before Flop (didn't bet)
Seat 3: R.Sarquis folded before Flop (didn't bet)
Seat 4: makrem81 folded before Flop (didn't bet)
Seat 5: DaveGregaz folded before Flop (didn't bet)
Seat 6: AlyCWB folded before Flop (didn't bet)
Seat 7: zoologikos (button) folded before Flop (didn't bet)
Seat 8: Sempre Nessa (small blind) folded before Flop
Seat 9: IgorMcgregor (big blind) folded before Flop



PokerStars Hand #201885037150: Tournament #2634449693, $0.98+$0.12 USD Hold'em No Limit - Level X (1000/2000) - 2019/06/30 17:11:06 BRT [2019/06/30 16:11:06 ET]
Table '2634449693 122' 9-max Seat #8 is the button
Seat 1: mrmajestic68 (54240 in chips) 
Seat 2: Wolks09 (94720 in chips) 
Seat 3: R.Sarquis (86343 in chips) 
Seat 4: makrem81 (85786 in chips) 
Seat 5: DaveGregaz (46160 in chips) 
Seat 6: AlyCWB (106945 in chips) 
Seat 7: zoologikos (41086 in chips) 
Seat 8: Sempre Nessa (82458 in chips) 
Seat 9: IgorMcgregor (37366 in chips) 
mrmajestic68: posts the ante 200
Wolks09: posts the ante 200
R.Sarquis: posts the ante 200
makrem81: posts the ante 200
DaveGregaz: posts the ante 200
AlyCWB: posts the ante 200
zoologikos: posts the ante 200
Sempre Nessa: posts the ante 200
IgorMcgregor: posts the ante 200
IgorMcgregor: posts small blind 1000
mrmajestic68: posts big blind 2000
*** HOLE CARDS ***
Dealt to AlyCWB [Qs 5h]
Wolks09: folds 
R.Sarquis: folds 
makrem81: calls 2000
DaveGregaz: folds 
AlyCWB: folds 
zoologikos: folds 
Sempre Nessa: folds 
IgorMcgregor: calls 1000
mrmajestic68: raises 7800 to 9800
makrem81 has timed out
makrem81: folds 
makrem81 is sitting out
IgorMcgregor: folds 
Uncalled bet (7800) returned to mrmajestic68
mrmajestic68 collected 7800 from pot
*** SUMMARY ***
Total pot 7800 | Rake 0 
Seat 1: mrmajestic68 (big blind) collected (7800)
Seat 2: Wolks09 folded before Flop (didn't bet)
Seat 3: R.Sarquis folded before Flop (didn't bet)
Seat 4: makrem81 folded before Flop
Seat 5: DaveGregaz folded before Flop (didn't bet)
Seat 6: AlyCWB folded before Flop (didn't bet)
Seat 7: zoologikos folded before Flop (didn't bet)
Seat 8: Sempre Nessa (button) folded before Flop (didn't bet)
Seat 9: IgorMcgregor (small blind) folded before Flop



PokerStars Hand #201885078578: Tournament #2634449693, $0.98+$0.12 USD Hold'em No Limit - Level X (1000/2000) - 2019/06/30 17:12:06 BRT [2019/06/30 16:12:06 ET]
Table '2634449693 122' 9-max Seat #9 is the button
Seat 1: mrmajestic68 (59840 in chips) 
Seat 2: Wolks09 (94520 in chips) 
Seat 3: R.Sarquis (86143 in chips) 
Seat 4: makrem81 (83586 in chips) is sitting out
Seat 5: DaveGregaz (45960 in chips) 
Seat 6: AlyCWB (106745 in chips) 
Seat 7: zoologikos (40886 in chips) 
Seat 8: Sempre Nessa (82258 in chips) 
Seat 9: IgorMcgregor (35166 in chips) 
mrmajestic68: posts the ante 200
Wolks09: posts the ante 200
R.Sarquis: posts the ante 200
makrem81: posts the ante 200
DaveGregaz: posts the ante 200
AlyCWB: posts the ante 200
zoologikos: posts the ante 200
Sempre Nessa: posts the ante 200
IgorMcgregor: posts the ante 200
mrmajestic68: posts small blind 1000
Wolks09: posts big blind 2000
*** HOLE CARDS ***
Dealt to AlyCWB [5s Kc]
makrem81 has returned
R.Sarquis: folds 
makrem81: folds 
DaveGregaz: folds 
AlyCWB: folds 
zoologikos: folds 
Sempre Nessa: raises 2000 to 4000
IgorMcgregor: folds 
mrmajestic68 is disconnected 
mrmajestic68 has timed out while disconnected
mrmajestic68: folds 
mrmajestic68 is sitting out
Wolks09: folds 
Uncalled bet (2000) returned to Sempre Nessa
Sempre Nessa collected 6800 from pot
Sempre Nessa: doesn't show hand 
*** SUMMARY ***
Total pot 6800 | Rake 0 
Seat 1: mrmajestic68 (small blind) folded before Flop
Seat 2: Wolks09 (big blind) folded before Flop
Seat 3: R.Sarquis folded before Flop (didn't bet)
Seat 4: makrem81 folded before Flop (didn't bet)
Seat 5: DaveGregaz folded before Flop (didn't bet)
Seat 6: AlyCWB folded before Flop (didn't bet)
Seat 7: zoologikos folded before Flop (didn't bet)
Seat 8: Sempre Nessa collected (6800)
Seat 9: IgorMcgregor (button) folded before Flop (didn't bet)



PokerStars Hand #201885108877: Tournament #2634449693, $0.98+$0.12 USD Hold'em No Limit - Level X (1000/2000) - 2019/06/30 17:12:50 BRT [2019/06/30 16:12:50 ET]
Table '2634449693 122' 9-max Seat #1 is the button
Seat 1: mrmajestic68 (58640 in chips) is sitting out
Seat 2: Wolks09 (92320 in chips) 
Seat 3: R.Sarquis (85943 in chips) 
Seat 4: makrem81 (83386 in chips) 
Seat 5: DaveGregaz (45760 in chips) 
Seat 6: AlyCWB (106545 in chips) 
Seat 7: zoologikos (40686 in chips) 
Seat 8: Sempre Nessa (86858 in chips) 
Seat 9: IgorMcgregor (34966 in chips) 
mrmajestic68: posts the ante 200
Wolks09: posts the ante 200
R.Sarquis: posts the ante 200
makrem81: posts the ante 200
DaveGregaz: posts the ante 200
AlyCWB: posts the ante 200
zoologikos: posts the ante 200
Sempre Nessa: posts the ante 200
IgorMcgregor: posts the ante 200
Wolks09: posts small blind 1000
R.Sarquis: posts big blind 2000
*** HOLE CARDS ***
Dealt to AlyCWB [8d Kc]
makrem81: folds 
DaveGregaz: folds 
AlyCWB: folds 
zoologikos: raises 2874 to 4874
Sempre Nessa: folds 
IgorMcgregor: calls 4874
mrmajestic68: folds 
Wolks09: folds 
R.Sarquis: folds 
*** FLOP *** [Qc 4c 5h]
mrmajestic68 has returned
zoologikos: checks 
IgorMcgregor: bets 10766
zoologikos: folds 
Uncalled bet (10766) returned to IgorMcgregor
IgorMcgregor collected 14548 from pot
IgorMcgregor: doesn't show hand 
*** SUMMARY ***
Total pot 14548 | Rake 0 
Board [Qc 4c 5h]
Seat 1: mrmajestic68 (button) folded before Flop (didn't bet)
Seat 2: Wolks09 (small blind) folded before Flop
Seat 3: R.Sarquis (big blind) folded before Flop
Seat 4: makrem81 folded before Flop (didn't bet)
Seat 5: DaveGregaz folded before Flop (didn't bet)
Seat 6: AlyCWB folded before Flop (didn't bet)
Seat 7: zoologikos folded on the Flop
Seat 8: Sempre Nessa folded before Flop (didn't bet)
Seat 9: IgorMcgregor collected (14548)



PokerStars Hand #201885150305: Tournament #2634449693, $0.98+$0.12 USD Hold'em No Limit - Level XI (1200/2400) - 2019/06/30 17:13:49 BRT [2019/06/30 16:13:49 ET]
Table '2634449693 122' 9-max Seat #2 is the button
Seat 1: mrmajestic68 (58440 in chips) 
Seat 2: Wolks09 (91120 in chips) 
Seat 3: R.Sarquis (83743 in chips) 
Seat 4: makrem81 (83186 in chips) 
Seat 5: DaveGregaz (45560 in chips) 
Seat 6: AlyCWB (106345 in chips) 
Seat 7: zoologikos (35612 in chips) 
Seat 8: Sempre Nessa (86658 in chips) 
Seat 9: IgorMcgregor (44440 in chips) 
mrmajestic68: posts the ante 240
Wolks09: posts the ante 240
R.Sarquis: posts the ante 240
makrem81: posts the ante 240
DaveGregaz: posts the ante 240
AlyCWB: posts the ante 240
zoologikos: posts the ante 240
Sempre Nessa: posts the ante 240
IgorMcgregor: posts the ante 240
R.Sarquis: posts small blind 1200
makrem81: posts big blind 2400
*** HOLE CARDS ***
Dealt to AlyCWB [6h 2s]
DaveGregaz: folds 
AlyCWB: folds 
zoologikos: folds 
Sempre Nessa: folds 
IgorMcgregor: folds 
mrmajestic68: folds 
Wolks09: folds 
R.Sarquis: folds 
Uncalled bet (1200) returned to makrem81
makrem81 collected 4560 from pot
makrem81: doesn't show hand 
*** SUMMARY ***
Total pot 4560 | Rake 0 
Seat 1: mrmajestic68 folded before Flop (didn't bet)
Seat 2: Wolks09 (button) folded before Flop (didn't bet)
Seat 3: R.Sarquis (small blind) folded before Flop
Seat 4: makrem81 (big blind) collected (4560)
Seat 5: DaveGregaz folded before Flop (didn't bet)
Seat 6: AlyCWB folded before Flop (didn't bet)
Seat 7: zoologikos folded before Flop (didn't bet)
Seat 8: Sempre Nessa folded before Flop (didn't bet)
Seat 9: IgorMcgregor folded before Flop (didn't bet)



PokerStars Hand #201885165953: Tournament #2634449693, $0.98+$0.12 USD Hold'em No Limit - Level XI (1200/2400) - 2019/06/30 17:14:12 BRT [2019/06/30 16:14:12 ET]
Table '2634449693 122' 9-max Seat #3 is the button
Seat 1: mrmajestic68 (58200 in chips) 
Seat 2: Wolks09 (90880 in chips) 
Seat 3: R.Sarquis (82303 in chips) 
Seat 4: makrem81 (86306 in chips) 
Seat 5: DaveGregaz (45320 in chips) 
Seat 6: AlyCWB (106105 in chips) 
Seat 7: zoologikos (35372 in chips) 
Seat 8: Sempre Nessa (86418 in chips) 
Seat 9: IgorMcgregor (44200 in chips) 
mrmajestic68: posts the ante 240
Wolks09: posts the ante 240
R.Sarquis: posts the ante 240
makrem81: posts the ante 240
DaveGregaz: posts the ante 240
AlyCWB: posts the ante 240
zoologikos: posts the ante 240
Sempre Nessa: posts the ante 240
IgorMcgregor: posts the ante 240
makrem81: posts small blind 1200
DaveGregaz: posts big blind 2400
*** HOLE CARDS ***
Dealt to AlyCWB [4d Ts]
AlyCWB: folds 
zoologikos: folds 
Sempre Nessa: folds 
IgorMcgregor: folds 
mrmajestic68: folds 
Wolks09: folds 
R.Sarquis: folds 
makrem81: raises 4800 to 7200
DaveGregaz: calls 4800
*** FLOP *** [Js 6c 6h]
makrem81: bets 8280
DaveGregaz: raises 29600 to 37880 and is all-in
makrem81: calls 29600
*** TURN *** [Js 6c 6h] [Jc]
*** RIVER *** [Js 6c 6h Jc] [6s]
*** SHOW DOWN ***
makrem81: shows [Kh Kc] (a full house, Sixes full of Kings)
DaveGregaz: shows [9s Jd] (a full house, Jacks full of Sixes)
DaveGregaz collected 92320 from pot
*** SUMMARY ***
Total pot 92320 | Rake 0 
Board [Js 6c 6h Jc 6s]
Seat 1: mrmajestic68 folded before Flop (didn't bet)
Seat 2: Wolks09 folded before Flop (didn't bet)
Seat 3: R.Sarquis (button) folded before Flop (didn't bet)
Seat 4: makrem81 (small blind) showed [Kh Kc] and lost with a full house, Sixes full of Kings
Seat 5: DaveGregaz (big blind) showed [9s Jd] and won (92320) with a full house, Jacks full of Sixes
Seat 6: AlyCWB folded before Flop (didn't bet)
Seat 7: zoologikos folded before Flop (didn't bet)
Seat 8: Sempre Nessa folded before Flop (didn't bet)
Seat 9: IgorMcgregor folded before Flop (didn't bet)



PokerStars Hand #201885201519: Tournament #2634449693, $0.98+$0.12 USD Hold'em No Limit - Level XI (1200/2400) - 2019/06/30 17:15:03 BRT [2019/06/30 16:15:03 ET]
Table '2634449693 122' 9-max Seat #4 is the button
Seat 1: mrmajestic68 (57960 in chips) 
Seat 2: Wolks09 (90640 in chips) 
Seat 3: R.Sarquis (82063 in chips) 
Seat 4: makrem81 (40986 in chips) 
Seat 5: DaveGregaz (92320 in chips) 
Seat 6: AlyCWB (105865 in chips) 
Seat 7: zoologikos (35132 in chips) 
Seat 8: Sempre Nessa (86178 in chips) 
Seat 9: IgorMcgregor (43960 in chips) 
mrmajestic68: posts the ante 240
Wolks09: posts the ante 240
R.Sarquis: posts the ante 240
makrem81: posts the ante 240
DaveGregaz: posts the ante 240
AlyCWB: posts the ante 240
zoologikos: posts the ante 240
Sempre Nessa: posts the ante 240
IgorMcgregor: posts the ante 240
DaveGregaz: posts small blind 1200
AlyCWB: posts big blind 2400
*** HOLE CARDS ***
Dealt to AlyCWB [Jh Qs]
zoologikos: folds 
Sempre Nessa: folds 
IgorMcgregor: folds 
mrmajestic68: raises 4800 to 7200
Wolks09: folds 
R.Sarquis: folds 
makrem81: raises 33546 to 40746 and is all-in
DaveGregaz: folds 
AlyCWB: folds 
mrmajestic68: calls 33546
*** FLOP *** [Ad 4h As]
*** TURN *** [Ad 4h As] [7c]
*** RIVER *** [Ad 4h As 7c] [7d]
*** SHOW DOWN ***
mrmajestic68: shows [Qc Kh] (two pair, Aces and Sevens)
makrem81: shows [2h 9d] (two pair, Aces and Sevens - lower kicker)
mrmajestic68 collected 87252 from pot
makrem81 finished the tournament
*** SUMMARY ***
Total pot 87252 | Rake 0 
Board [Ad 4h As 7c 7d]
Seat 1: mrmajestic68 showed [Qc Kh] and won (87252) with two pair, Aces and Sevens
Seat 2: Wolks09 folded before Flop (didn't bet)
Seat 3: R.Sarquis folded before Flop (didn't bet)
Seat 4: makrem81 (button) showed [2h 9d] and lost with two pair, Aces and Sevens
Seat 5: DaveGregaz (small blind) folded before Flop
Seat 6: AlyCWB (big blind) folded before Flop
Seat 7: zoologikos folded before Flop (didn't bet)
Seat 8: Sempre Nessa folded before Flop (didn't bet)
Seat 9: IgorMcgregor folded before Flop (didn't bet)



PokerStars Hand #201885233083: Tournament #2634449693, $0.98+$0.12 USD Hold'em No Limit - Level XI (1200/2400) - 2019/06/30 17:15:48 BRT [2019/06/30 16:15:48 ET]
Table '2634449693 122' 9-max Seat #5 is the button
Seat 1: mrmajestic68 (104226 in chips) 
Seat 2: Wolks09 (90400 in chips) 
Seat 3: R.Sarquis (81823 in chips) 
Seat 5: DaveGregaz (90880 in chips) 
Seat 6: AlyCWB (103225 in chips) 
Seat 7: zoologikos (34892 in chips) 
Seat 8: Sempre Nessa (85938 in chips) 
Seat 9: IgorMcgregor (43720 in chips) 
mrmajestic68: posts the ante 240
Wolks09: posts the ante 240
R.Sarquis: posts the ante 240
DaveGregaz: posts the ante 240
AlyCWB: posts the ante 240
zoologikos: posts the ante 240
Sempre Nessa: posts the ante 240
IgorMcgregor: posts the ante 240
AlyCWB: posts small blind 1200
zoologikos: posts big blind 2400
*** HOLE CARDS ***
Dealt to AlyCWB [Jh Qh]
Sempre Nessa: folds 
IgorMcgregor: folds 
mrmajestic68: folds 
Wolks09: folds 
R.Sarquis: folds 
DaveGregaz: raises 3600 to 6000
AlyCWB: calls 4800
zoologikos: folds 
*** FLOP *** [4h Kc 2s]
AlyCWB is connected 
AlyCWB: checks 
DaveGregaz: checks 
*** TURN *** [4h Kc 2s] [9s]
AlyCWB: checks 
DaveGregaz: bets 8777
AlyCWB: calls 8777
*** RIVER *** [4h Kc 2s 9s] [6h]
AlyCWB: bets 9600
DaveGregaz: folds 
Uncalled bet (9600) returned to AlyCWB
AlyCWB collected 33874 from pot
*** SUMMARY ***
Total pot 33874 | Rake 0 
Board [4h Kc 2s 9s 6h]
Seat 1: mrmajestic68 folded before Flop (didn't bet)
Seat 2: Wolks09 folded before Flop (didn't bet)
Seat 3: R.Sarquis folded before Flop (didn't bet)
Seat 5: DaveGregaz (button) folded on the River
Seat 6: AlyCWB (small blind) collected (33874)
Seat 7: zoologikos (big blind) folded before Flop
Seat 8: Sempre Nessa folded before Flop (didn't bet)
Seat 9: IgorMcgregor folded before Flop (didn't bet)



PokerStars Hand #201885300236: Tournament #2634449693, $0.98+$0.12 USD Hold'em No Limit - Level XI (1200/2400) - 2019/06/30 17:17:23 BRT [2019/06/30 16:17:23 ET]
Table '2634449693 122' 9-max Seat #6 is the button
Seat 1: mrmajestic68 (103986 in chips) 
Seat 2: Wolks09 (90160 in chips) 
Seat 3: R.Sarquis (81583 in chips) 
Seat 4: stixvspapo (50000 in chips) 
Seat 5: DaveGregaz (75863 in chips) 
Seat 6: AlyCWB (122082 in chips) 
Seat 7: zoologikos (32252 in chips) 
Seat 8: Sempre Nessa (85698 in chips) 
Seat 9: IgorMcgregor (43480 in chips) 
mrmajestic68: posts the ante 240
Wolks09: posts the ante 240
R.Sarquis: posts the ante 240
stixvspapo: posts the ante 240
DaveGregaz: posts the ante 240
AlyCWB: posts the ante 240
zoologikos: posts the ante 240
Sempre Nessa: posts the ante 240
IgorMcgregor: posts the ante 240
zoologikos: posts small blind 1200
Sempre Nessa: posts big blind 2400
*** HOLE CARDS ***
Dealt to AlyCWB [Qs 3h]
IgorMcgregor: folds 
mrmajestic68: folds 
Wolks09: folds 
R.Sarquis: raises 2640 to 5040
stixvspapo: folds 
DaveGregaz: folds 
AlyCWB: folds 
zoologikos: folds 
Sempre Nessa: calls 2640
*** FLOP *** [Jd 2h Qd]
Sempre Nessa: checks 
R.Sarquis: checks 
*** TURN *** [Jd 2h Qd] [3s]
Sempre Nessa: bets 6720
R.Sarquis: folds 
Uncalled bet (6720) returned to Sempre Nessa
Sempre Nessa collected 13440 from pot
Sempre Nessa: doesn't show hand 
*** SUMMARY ***
Total pot 13440 | Rake 0 
Board [Jd 2h Qd 3s]
Seat 1: mrmajestic68 folded before Flop (didn't bet)
Seat 2: Wolks09 folded before Flop (didn't bet)
Seat 3: R.Sarquis folded on the Turn
Seat 4: stixvspapo folded before Flop (didn't bet)
Seat 5: DaveGregaz folded before Flop (didn't bet)
Seat 6: AlyCWB (button) folded before Flop (didn't bet)
Seat 7: zoologikos (small blind) folded before Flop
Seat 8: Sempre Nessa (big blind) collected (13440)
Seat 9: IgorMcgregor folded before Flop (didn't bet)



PokerStars Hand #201885335310: Tournament #2634449693, $0.98+$0.12 USD Hold'em No Limit - Level XII (1400/2800) - 2019/06/30 17:18:12 BRT [2019/06/30 16:18:12 ET]
Table '2634449693 122' 9-max Seat #7 is the button
Seat 1: mrmajestic68 (103746 in chips) 
Seat 2: Wolks09 (89920 in chips) 
Seat 4: stixvspapo (49760 in chips) 
Seat 5: DaveGregaz (75623 in chips) 
Seat 6: AlyCWB (121842 in chips) 
Seat 7: zoologikos (30812 in chips) 
Seat 8: Sempre Nessa (93858 in chips) 
Seat 9: IgorMcgregor (43240 in chips) 
mrmajestic68: posts the ante 280
Wolks09: posts the ante 280
stixvspapo: posts the ante 280
DaveGregaz: posts the ante 280
AlyCWB: posts the ante 280
zoologikos: posts the ante 280
Sempre Nessa: posts the ante 280
IgorMcgregor: posts the ante 280
Sempre Nessa: posts small blind 1400
IgorMcgregor: posts big blind 2800
*** HOLE CARDS ***
Dealt to AlyCWB [9d 6h]
mrmajestic68: folds 
Wolks09: folds 
stixvspapo: raises 3080 to 5880
DaveGregaz: folds 
AlyCWB: folds 
zoologikos: folds 
Sempre Nessa: folds 
IgorMcgregor: folds 
Uncalled bet (3080) returned to stixvspapo
stixvspapo collected 9240 from pot
stixvspapo: doesn't show hand 
*** SUMMARY ***
Total pot 9240 | Rake 0 
Seat 1: mrmajestic68 folded before Flop (didn't bet)
Seat 2: Wolks09 folded before Flop (didn't bet)
Seat 4: stixvspapo collected (9240)
Seat 5: DaveGregaz folded before Flop (didn't bet)
Seat 6: AlyCWB folded before Flop (didn't bet)
Seat 7: zoologikos (button) folded before Flop (didn't bet)
Seat 8: Sempre Nessa (small blind) folded before Flop
Seat 9: IgorMcgregor (big blind) folded before Flop



PokerStars Hand #201885356326: Tournament #2634449693, $0.98+$0.12 USD Hold'em No Limit - Level XII (1400/2800) - 2019/06/30 17:18:41 BRT [2019/06/30 16:18:41 ET]
Table '2634449693 122' 9-max Seat #8 is the button
Seat 1: mrmajestic68 (103466 in chips) 
Seat 2: Wolks09 (89640 in chips) 
Seat 3: lemondrizzy3 (50000 in chips) 
Seat 4: stixvspapo (55920 in chips) 
Seat 5: DaveGregaz (75343 in chips) 
Seat 6: AlyCWB (121562 in chips) 
Seat 7: zoologikos (30532 in chips) 
Seat 8: Sempre Nessa (92178 in chips) 
Seat 9: IgorMcgregor (40160 in chips) 
mrmajestic68: posts the ante 280
Wolks09: posts the ante 280
lemondrizzy3: posts the ante 280
stixvspapo: posts the ante 280
DaveGregaz: posts the ante 280
AlyCWB: posts the ante 280
zoologikos: posts the ante 280
Sempre Nessa: posts the ante 280
IgorMcgregor: posts the ante 280
IgorMcgregor: posts small blind 1400
mrmajestic68: posts big blind 2800
*** HOLE CARDS ***
Dealt to AlyCWB [Ah 7d]
Wolks09: folds 
lemondrizzy3: folds 
stixvspapo: folds 
DaveGregaz: raises 4200 to 7000
AlyCWB: folds 
zoologikos: folds 
Sempre Nessa: folds 
IgorMcgregor: folds 
mrmajestic68: calls 4200
*** FLOP *** [4d 4h 7h]
mrmajestic68: checks 
DaveGregaz: bets 5914
mrmajestic68: folds 
Uncalled bet (5914) returned to DaveGregaz
DaveGregaz collected 17920 from pot
*** SUMMARY ***
Total pot 17920 | Rake 0 
Board [4d 4h 7h]
Seat 1: mrmajestic68 (big blind) folded on the Flop
Seat 2: Wolks09 folded before Flop (didn't bet)
Seat 3: lemondrizzy3 folded before Flop (didn't bet)
Seat 4: stixvspapo folded before Flop (didn't bet)
Seat 5: DaveGregaz collected (17920)
Seat 6: AlyCWB folded before Flop (didn't bet)
Seat 7: zoologikos folded before Flop (didn't bet)
Seat 8: Sempre Nessa (button) folded before Flop (didn't bet)
Seat 9: IgorMcgregor (small blind) folded before Flop



PokerStars Hand #201885384547: Tournament #2634449693, $0.98+$0.12 USD Hold'em No Limit - Level XII (1400/2800) - 2019/06/30 17:19:21 BRT [2019/06/30 16:19:21 ET]
Table '2634449693 122' 9-max Seat #9 is the button
Seat 1: mrmajestic68 (96186 in chips) 
Seat 2: Wolks09 (89360 in chips) 
Seat 3: lemondrizzy3 (49720 in chips) 
Seat 4: stixvspapo (55640 in chips) 
Seat 5: DaveGregaz (85983 in chips) 
Seat 6: AlyCWB (121282 in chips) 
Seat 7: zoologikos (30252 in chips) 
Seat 8: Sempre Nessa (91898 in chips) 
Seat 9: IgorMcgregor (38480 in chips) 
mrmajestic68: posts the ante 280
Wolks09: posts the ante 280
lemondrizzy3: posts the ante 280
stixvspapo: posts the ante 280
DaveGregaz: posts the ante 280
AlyCWB: posts the ante 280
zoologikos: posts the ante 280
Sempre Nessa: posts the ante 280
IgorMcgregor: posts the ante 280
mrmajestic68: posts small blind 1400
Wolks09: posts big blind 2800
*** HOLE CARDS ***
Dealt to AlyCWB [Ts Qc]
lemondrizzy3: folds 
stixvspapo: folds 
DaveGregaz: folds 
AlyCWB: raises 3400 to 6200
zoologikos: folds 
Sempre Nessa: raises 10600 to 16800
IgorMcgregor: folds 
mrmajestic68: folds 
Wolks09: folds 
AlyCWB: calls 10600
*** FLOP *** [Ks Qd 2d]
AlyCWB: checks 
Sempre Nessa: bets 12096
AlyCWB: calls 12096
*** TURN *** [Ks Qd 2d] [2h]
AlyCWB: checks 
Sempre Nessa: checks 
*** RIVER *** [Ks Qd 2d 2h] [7h]
AlyCWB: checks 
Sempre Nessa: checks 
*** SHOW DOWN ***
AlyCWB: shows [Ts Qc] (two pair, Queens and Deuces)
Sempre Nessa: mucks hand 
AlyCWB collected 64512 from pot
*** SUMMARY ***
Total pot 64512 | Rake 0 
Board [Ks Qd 2d 2h 7h]
Seat 1: mrmajestic68 (small blind) folded before Flop
Seat 2: Wolks09 (big blind) folded before Flop
Seat 3: lemondrizzy3 folded before Flop (didn't bet)
Seat 4: stixvspapo folded before Flop (didn't bet)
Seat 5: DaveGregaz folded before Flop (didn't bet)
Seat 6: AlyCWB showed [Ts Qc] and won (64512) with two pair, Queens and Deuces
Seat 7: zoologikos folded before Flop (didn't bet)
Seat 8: Sempre Nessa mucked [Ad 9d]
Seat 9: IgorMcgregor (button) folded before Flop (didn't bet)



PokerStars Hand #201885436160: Tournament #2634449693, $0.98+$0.12 USD Hold'em No Limit - Level XII (1400/2800) - 2019/06/30 17:20:34 BRT [2019/06/30 16:20:34 ET]
Table '2634449693 122' 9-max Seat #1 is the button
Seat 1: mrmajestic68 (94506 in chips) 
Seat 2: Wolks09 (86280 in chips) 
Seat 3: lemondrizzy3 (49440 in chips) 
Seat 4: stixvspapo (55360 in chips) 
Seat 5: DaveGregaz (85703 in chips) 
Seat 6: AlyCWB (156618 in chips) 
Seat 7: zoologikos (29972 in chips) 
Seat 8: Sempre Nessa (62722 in chips) 
Seat 9: IgorMcgregor (38200 in chips) 
mrmajestic68: posts the ante 280
Wolks09: posts the ante 280
lemondrizzy3: posts the ante 280
stixvspapo: posts the ante 280
DaveGregaz: posts the ante 280
AlyCWB: posts the ante 280
zoologikos: posts the ante 280
Sempre Nessa: posts the ante 280
IgorMcgregor: posts the ante 280
Wolks09: posts small blind 1400
lemondrizzy3: posts big blind 2800
*** HOLE CARDS ***
Dealt to AlyCWB [4c Kh]
stixvspapo: folds 
DaveGregaz: folds 
AlyCWB: folds 
zoologikos: folds 
Sempre Nessa: folds 
IgorMcgregor: folds 
mrmajestic68: folds 
Wolks09: raises 5600 to 8400
lemondrizzy3: folds 
Uncalled bet (5600) returned to Wolks09
Wolks09 collected 8120 from pot
*** SUMMARY ***
Total pot 8120 | Rake 0 
Seat 1: mrmajestic68 (button) folded before Flop (didn't bet)
Seat 2: Wolks09 (small blind) collected (8120)
Seat 3: lemondrizzy3 (big blind) folded before Flop
Seat 4: stixvspapo folded before Flop (didn't bet)
Seat 5: DaveGregaz folded before Flop (didn't bet)
Seat 6: AlyCWB folded before Flop (didn't bet)
Seat 7: zoologikos folded before Flop (didn't bet)
Seat 8: Sempre Nessa folded before Flop (didn't bet)
Seat 9: IgorMcgregor folded before Flop (didn't bet)



PokerStars Hand #201885466243: Tournament #2634449693, $0.98+$0.12 USD Hold'em No Limit - Level XII (1400/2800) - 2019/06/30 17:21:17 BRT [2019/06/30 16:21:17 ET]
Table '2634449693 122' 9-max Seat #2 is the button
Seat 1: mrmajestic68 (94226 in chips) 
Seat 2: Wolks09 (91320 in chips) 
Seat 3: lemondrizzy3 (46360 in chips) 
Seat 4: stixvspapo (55080 in chips) 
Seat 5: DaveGregaz (85423 in chips) 
Seat 6: AlyCWB (156338 in chips) 
Seat 7: zoologikos (29692 in chips) 
Seat 8: Sempre Nessa (62442 in chips) 
Seat 9: IgorMcgregor (37920 in chips) 
mrmajestic68: posts the ante 280
Wolks09: posts the ante 280
lemondrizzy3: posts the ante 280
stixvspapo: posts the ante 280
DaveGregaz: posts the ante 280
AlyCWB: posts the ante 280
zoologikos: posts the ante 280
Sempre Nessa: posts the ante 280
IgorMcgregor: posts the ante 280
lemondrizzy3: posts small blind 1400
stixvspapo: posts big blind 2800
*** HOLE CARDS ***
Dealt to AlyCWB [3c Ac]
DaveGregaz: folds 
AlyCWB: folds 
zoologikos: folds 
Sempre Nessa: folds 
IgorMcgregor: raises 34840 to 37640 and is all-in
mrmajestic68: folds 
Wolks09: folds 
lemondrizzy3: folds 
stixvspapo: folds 
Uncalled bet (34840) returned to IgorMcgregor
IgorMcgregor collected 9520 from pot
IgorMcgregor: doesn't show hand 
*** SUMMARY ***
Total pot 9520 | Rake 0 
Seat 1: mrmajestic68 folded before Flop (didn't bet)
Seat 2: Wolks09 (button) folded before Flop (didn't bet)
Seat 3: lemondrizzy3 (small blind) folded before Flop
Seat 4: stixvspapo (big blind) folded before Flop
Seat 5: DaveGregaz folded before Flop (didn't bet)
Seat 6: AlyCWB folded before Flop (didn't bet)
Seat 7: zoologikos folded before Flop (didn't bet)
Seat 8: Sempre Nessa folded before Flop (didn't bet)
Seat 9: IgorMcgregor collected (9520)



PokerStars Hand #201885501210: Tournament #2634449693, $0.98+$0.12 USD Hold'em No Limit - Level XII (1400/2800) - 2019/06/30 17:22:06 BRT [2019/06/30 16:22:06 ET]
Table '2634449693 122' 9-max Seat #3 is the button
Seat 1: mrmajestic68 (93946 in chips) 
Seat 2: Wolks09 (91040 in chips) 
Seat 3: lemondrizzy3 (44680 in chips) 
Seat 4: stixvspapo (52000 in chips) 
Seat 5: DaveGregaz (85143 in chips) 
Seat 6: AlyCWB (156058 in chips) 
Seat 7: zoologikos (29412 in chips) 
Seat 8: Sempre Nessa (62162 in chips) 
Seat 9: IgorMcgregor (44360 in chips) 
mrmajestic68: posts the ante 280
Wolks09: posts the ante 280
lemondrizzy3: posts the ante 280
stixvspapo: posts the ante 280
DaveGregaz: posts the ante 280
AlyCWB: posts the ante 280
zoologikos: posts the ante 280
Sempre Nessa: posts the ante 280
IgorMcgregor: posts the ante 280
stixvspapo: posts small blind 1400
DaveGregaz: posts big blind 2800
*** HOLE CARDS ***
Dealt to AlyCWB [3c Jc]
AlyCWB: folds 
zoologikos: folds 
Sempre Nessa: folds 
IgorMcgregor: folds 
mrmajestic68: folds 
Wolks09: raises 2800 to 5600
lemondrizzy3: folds 
stixvspapo: raises 44800 to 50400
DaveGregaz: folds 
Wolks09: raises 40360 to 90760 and is all-in
stixvspapo: calls 1320 and is all-in
Uncalled bet (39040) returned to Wolks09
*** FLOP *** [6d 3s Jh]
*** TURN *** [6d 3s Jh] [Qd]
*** RIVER *** [6d 3s Jh Qd] [Qc]
*** SHOW DOWN ***
stixvspapo: shows [8c 8d] (two pair, Queens and Eights)
Wolks09: shows [Ah Jd] (two pair, Queens and Jacks)
Wolks09 collected 108760 from pot
stixvspapo finished the tournament
*** SUMMARY ***
Total pot 108760 | Rake 0 
Board [6d 3s Jh Qd Qc]
Seat 1: mrmajestic68 folded before Flop (didn't bet)
Seat 2: Wolks09 showed [Ah Jd] and won (108760) with two pair, Queens and Jacks
Seat 3: lemondrizzy3 (button) folded before Flop (didn't bet)
Seat 4: stixvspapo (small blind) showed [8c 8d] and lost with two pair, Queens and Eights
Seat 5: DaveGregaz (big blind) folded before Flop
Seat 6: AlyCWB folded before Flop (didn't bet)
Seat 7: zoologikos folded before Flop (didn't bet)
Seat 8: Sempre Nessa folded before Flop (didn't bet)
Seat 9: IgorMcgregor folded before Flop (didn't bet)



PokerStars Hand #201885541224: Tournament #2634449693, $0.98+$0.12 USD Hold'em No Limit - Level XII (1400/2800) - 2019/06/30 17:23:03 BRT [2019/06/30 16:23:03 ET]
Table '2634449693 133' 9-max Seat #1 is the button
Seat 1: joaomcneto (33010 in chips) 
Seat 2: SilencedCrow06 (105987 in chips) 
Seat 3: AlyCWB (155778 in chips) 
Seat 4: JRSOMBRIO (99040 in chips) 
Seat 5: JAPA Z/L (255768 in chips) 
Seat 6: Eneias27 (173510 in chips) 
Seat 7: GamblerCism (48576 in chips) 
Seat 8: b2yq (49440 in chips) 
Seat 9: moitoi87 (81244 in chips) 
joaomcneto: posts the ante 280
SilencedCrow06: posts the ante 280
AlyCWB: posts the ante 280
JRSOMBRIO: posts the ante 280
JAPA Z/L: posts the ante 280
Eneias27: posts the ante 280
GamblerCism: posts the ante 280
b2yq: posts the ante 280
moitoi87: posts the ante 280
SilencedCrow06: posts small blind 1400
AlyCWB: posts big blind 2800
*** HOLE CARDS ***
Dealt to AlyCWB [7s 4c]
JRSOMBRIO: folds 
JAPA Z/L: folds 
Eneias27: calls 2800
GamblerCism: folds 
b2yq: raises 28000 to 30800
moitoi87: folds 
joaomcneto: folds 
SilencedCrow06: folds 
AlyCWB: folds 
Eneias27: folds 
Uncalled bet (28000) returned to b2yq
b2yq collected 12320 from pot
b2yq: doesn't show hand 
*** SUMMARY ***
Total pot 12320 | Rake 0 
Seat 1: joaomcneto (button) folded before Flop (didn't bet)
Seat 2: SilencedCrow06 (small blind) folded before Flop
Seat 3: AlyCWB (big blind) folded before Flop
Seat 4: JRSOMBRIO folded before Flop (didn't bet)
Seat 5: JAPA Z/L folded before Flop (didn't bet)
Seat 6: Eneias27 folded before Flop
Seat 7: GamblerCism folded before Flop (didn't bet)
Seat 8: b2yq collected (12320)
Seat 9: moitoi87 folded before Flop (didn't bet)



PokerStars Hand #201885565205: Tournament #2634449693, $0.98+$0.12 USD Hold'em No Limit - Level XIII (1600/3200) - 2019/06/30 17:23:37 BRT [2019/06/30 16:23:37 ET]
Table '2634449693 133' 9-max Seat #2 is the button
Seat 1: joaomcneto (32730 in chips) 
Seat 2: SilencedCrow06 (104307 in chips) 
Seat 3: AlyCWB (152698 in chips) 
Seat 4: JRSOMBRIO (98760 in chips) 
Seat 5: JAPA Z/L (255488 in chips) 
Seat 6: Eneias27 (170430 in chips) 
Seat 7: GamblerCism (48296 in chips) 
Seat 8: b2yq (58680 in chips) 
Seat 9: moitoi87 (80964 in chips) 
joaomcneto: posts the ante 320
SilencedCrow06: posts the ante 320
AlyCWB: posts the ante 320
JRSOMBRIO: posts the ante 320
JAPA Z/L: posts the ante 320
Eneias27: posts the ante 320
GamblerCism: posts the ante 320
b2yq: posts the ante 320
moitoi87: posts the ante 320
AlyCWB: posts small blind 1600
JRSOMBRIO: posts big blind 3200
*** HOLE CARDS ***
Dealt to AlyCWB [4d 7s]
JAPA Z/L: raises 3200 to 6400
Eneias27: folds 
GamblerCism: folds 
b2yq: folds 
moitoi87: folds 
joaomcneto: folds 
SilencedCrow06: folds 
AlyCWB: folds 
JRSOMBRIO: folds 
Uncalled bet (3200) returned to JAPA Z/L
JAPA Z/L collected 10880 from pot
*** SUMMARY ***
Total pot 10880 | Rake 0 
Seat 1: joaomcneto folded before Flop (didn't bet)
Seat 2: SilencedCrow06 (button) folded before Flop (didn't bet)
Seat 3: AlyCWB (small blind) folded before Flop
Seat 4: JRSOMBRIO (big blind) folded before Flop
Seat 5: JAPA Z/L collected (10880)
Seat 6: Eneias27 folded before Flop (didn't bet)
Seat 7: GamblerCism folded before Flop (didn't bet)
Seat 8: b2yq folded before Flop (didn't bet)
Seat 9: moitoi87 folded before Flop (didn't bet)



PokerStars Hand #201885590733: Tournament #2634449693, $0.98+$0.12 USD Hold'em No Limit - Level XIII (1600/3200) - 2019/06/30 17:24:14 BRT [2019/06/30 16:24:14 ET]
Table '2634449693 133' 9-max Seat #3 is the button
Seat 1: joaomcneto (32410 in chips) 
Seat 2: SilencedCrow06 (103987 in chips) 
Seat 3: AlyCWB (150778 in chips) 
Seat 4: JRSOMBRIO (95240 in chips) 
Seat 5: JAPA Z/L (262848 in chips) 
Seat 6: Eneias27 (170110 in chips) 
Seat 7: GamblerCism (47976 in chips) 
Seat 8: b2yq (58360 in chips) 
Seat 9: moitoi87 (80644 in chips) 
joaomcneto: posts the ante 320
SilencedCrow06: posts the ante 320
AlyCWB: posts the ante 320
JRSOMBRIO: posts the ante 320
JAPA Z/L: posts the ante 320
Eneias27: posts the ante 320
GamblerCism: posts the ante 320
b2yq: posts the ante 320
moitoi87: posts the ante 320
JRSOMBRIO: posts small blind 1600
JAPA Z/L: posts big blind 3200
*** HOLE CARDS ***
Dealt to AlyCWB [Th 9h]
Eneias27: folds 
GamblerCism: folds 
b2yq: folds 
moitoi87: folds 
joaomcneto: folds 
SilencedCrow06: folds 
AlyCWB: raises 3200 to 6400
JRSOMBRIO: folds 
JAPA Z/L: calls 3200
*** FLOP *** [Jc 3h Ah]
JAPA Z/L: checks 
AlyCWB: checks 
*** TURN *** [Jc 3h Ah] [6d]
JAPA Z/L: checks 
AlyCWB: checks 
*** RIVER *** [Jc 3h Ah 6d] [4d]
JAPA Z/L: checks 
AlyCWB: bets 6400
JAPA Z/L: folds 
Uncalled bet (6400) returned to AlyCWB
AlyCWB collected 17280 from pot
*** SUMMARY ***
Total pot 17280 | Rake 0 
Board [Jc 3h Ah 6d 4d]
Seat 1: joaomcneto folded before Flop (didn't bet)
Seat 2: SilencedCrow06 folded before Flop (didn't bet)
Seat 3: AlyCWB (button) collected (17280)
Seat 4: JRSOMBRIO (small blind) folded before Flop
Seat 5: JAPA Z/L (big blind) folded on the River
Seat 6: Eneias27 folded before Flop (didn't bet)
Seat 7: GamblerCism folded before Flop (didn't bet)
Seat 8: b2yq folded before Flop (didn't bet)
Seat 9: moitoi87 folded before Flop (didn't bet)



PokerStars Hand #201885638581: Tournament #2634449693, $0.98+$0.12 USD Hold'em No Limit - Level XIII (1600/3200) - 2019/06/30 17:25:22 BRT [2019/06/30 16:25:22 ET]
Table '2634449693 133' 9-max Seat #4 is the button
Seat 1: joaomcneto (32090 in chips) 
Seat 2: SilencedCrow06 (103667 in chips) 
Seat 3: AlyCWB (161338 in chips) 
Seat 4: JRSOMBRIO (93320 in chips) 
Seat 5: JAPA Z/L (256128 in chips) 
Seat 6: Eneias27 (169790 in chips) 
Seat 7: GamblerCism (47656 in chips) 
Seat 8: b2yq (58040 in chips) 
Seat 9: moitoi87 (80324 in chips) 
joaomcneto: posts the ante 320
SilencedCrow06: posts the ante 320
AlyCWB: posts the ante 320
JRSOMBRIO: posts the ante 320
JAPA Z/L: posts the ante 320
Eneias27: posts the ante 320
GamblerCism: posts the ante 320
b2yq: posts the ante 320
moitoi87: posts the ante 320
JAPA Z/L: posts small blind 1600
Eneias27: posts big blind 3200
*** HOLE CARDS ***
Dealt to AlyCWB [5d As]
GamblerCism: folds 
b2yq: folds 
moitoi87: folds 
joaomcneto: folds 
SilencedCrow06: folds 
AlyCWB: raises 3200 to 6400
JRSOMBRIO: folds 
JAPA Z/L: folds 
Eneias27: calls 3200
*** FLOP *** [6c Qd Jh]
Eneias27: checks 
AlyCWB: bets 6400
Eneias27: calls 6400
*** TURN *** [6c Qd Jh] [6d]
Eneias27: checks 
AlyCWB: checks 
*** RIVER *** [6c Qd Jh 6d] [Qs]
Eneias27: checks 
AlyCWB: checks 
*** SHOW DOWN ***
Eneias27: shows [Ah 8h] (two pair, Queens and Sixes)
AlyCWB: shows [5d As] (two pair, Queens and Sixes)
Eneias27 collected 15040 from pot
AlyCWB collected 15040 from pot
*** SUMMARY ***
Total pot 30080 | Rake 0 
Board [6c Qd Jh 6d Qs]
Seat 1: joaomcneto folded before Flop (didn't bet)
Seat 2: SilencedCrow06 folded before Flop (didn't bet)
Seat 3: AlyCWB showed [5d As] and won (15040) with two pair, Queens and Sixes
Seat 4: JRSOMBRIO (button) folded before Flop (didn't bet)
Seat 5: JAPA Z/L (small blind) folded before Flop
Seat 6: Eneias27 (big blind) showed [Ah 8h] and won (15040) with two pair, Queens and Sixes
Seat 7: GamblerCism folded before Flop (didn't bet)
Seat 8: b2yq folded before Flop (didn't bet)
Seat 9: moitoi87 folded before Flop (didn't bet)



PokerStars Hand #201885684538: Tournament #2634449693, $0.98+$0.12 USD Hold'em No Limit - Level XIII (1600/3200) - 2019/06/30 17:26:27 BRT [2019/06/30 16:26:27 ET]
Table '2634449693 133' 9-max Seat #5 is the button
Seat 1: joaomcneto (31770 in chips) 
Seat 2: SilencedCrow06 (103347 in chips) 
Seat 3: AlyCWB (163258 in chips) 
Seat 4: JRSOMBRIO (93000 in chips) 
Seat 5: JAPA Z/L (254208 in chips) 
Seat 6: Eneias27 (171710 in chips) 
Seat 7: GamblerCism (47336 in chips) 
Seat 8: b2yq (57720 in chips) 
Seat 9: moitoi87 (80004 in chips) 
joaomcneto: posts the ante 320
SilencedCrow06: posts the ante 320
AlyCWB: posts the ante 320
JRSOMBRIO: posts the ante 320
JAPA Z/L: posts the ante 320
Eneias27: posts the ante 320
GamblerCism: posts the ante 320
b2yq: posts the ante 320
moitoi87: posts the ante 320
Eneias27: posts small blind 1600
GamblerCism: posts big blind 3200
*** HOLE CARDS ***
Dealt to AlyCWB [7d Ac]
b2yq: calls 3200
moitoi87: folds 
joaomcneto: folds 
SilencedCrow06: folds 
AlyCWB: folds 
JRSOMBRIO: folds 
JAPA Z/L: raises 6400 to 9600
Eneias27: folds 
GamblerCism: calls 6400
b2yq: calls 6400
*** FLOP *** [7h 2h Ts]
GamblerCism: checks 
b2yq: checks 
JAPA Z/L: bets 16640
GamblerCism: folds 
b2yq: folds 
Uncalled bet (16640) returned to JAPA Z/L
JAPA Z/L collected 33280 from pot
*** SUMMARY ***
Total pot 33280 | Rake 0 
Board [7h 2h Ts]
Seat 1: joaomcneto folded before Flop (didn't bet)
Seat 2: SilencedCrow06 folded before Flop (didn't bet)
Seat 3: AlyCWB folded before Flop (didn't bet)
Seat 4: JRSOMBRIO folded before Flop (didn't bet)
Seat 5: JAPA Z/L (button) collected (33280)
Seat 6: Eneias27 (small blind) folded before Flop
Seat 7: GamblerCism (big blind) folded on the Flop
Seat 8: b2yq folded on the Flop
Seat 9: moitoi87 folded before Flop (didn't bet)



PokerStars Hand #201885732752: Tournament #2634449693, $0.98+$0.12 USD Hold'em No Limit - Level XIII (1600/3200) - 2019/06/30 17:27:37 BRT [2019/06/30 16:27:37 ET]
Table '2634449693 133' 9-max Seat #6 is the button
Seat 1: joaomcneto (31450 in chips) 
Seat 2: SilencedCrow06 (103027 in chips) 
Seat 3: AlyCWB (162938 in chips) 
Seat 4: JRSOMBRIO (92680 in chips) 
Seat 5: JAPA Z/L (277568 in chips) 
Seat 6: Eneias27 (169790 in chips) 
Seat 7: GamblerCism (37416 in chips) 
Seat 8: b2yq (47800 in chips) 
Seat 9: moitoi87 (79684 in chips) 
joaomcneto: posts the ante 320
SilencedCrow06: posts the ante 320
AlyCWB: posts the ante 320
JRSOMBRIO: posts the ante 320
JAPA Z/L: posts the ante 320
Eneias27: posts the ante 320
GamblerCism: posts the ante 320
b2yq: posts the ante 320
moitoi87: posts the ante 320
GamblerCism: posts small blind 1600
b2yq: posts big blind 3200
*** HOLE CARDS ***
Dealt to AlyCWB [9h Tc]
moitoi87: raises 4960 to 8160
joaomcneto: folds 
SilencedCrow06: folds 
AlyCWB: folds 
JRSOMBRIO: folds 
JAPA Z/L: folds 
Eneias27: calls 8160
GamblerCism: folds 
b2yq: raises 39320 to 47480 and is all-in
moitoi87: calls 39320
Eneias27: calls 39320
*** FLOP *** [4c 2h 9s]
moitoi87: bets 31884 and is all-in
Eneias27: calls 31884
*** TURN *** [4c 2h 9s] [7s]
*** RIVER *** [4c 2h 9s 7s] [6s]
*** SHOW DOWN ***
moitoi87: shows [Ks Ac] (high card Ace)
Eneias27: shows [Jh 9c] (a pair of Nines)
Eneias27 collected 63768 from side pot
b2yq: shows [Qs Ah] (high card Ace)
Eneias27 collected 146920 from main pot
moitoi87 finished the tournament
b2yq finished the tournament
*** SUMMARY ***
Total pot 210688 Main pot 146920. Side pot 63768. | Rake 0 
Board [4c 2h 9s 7s 6s]
Seat 1: joaomcneto folded before Flop (didn't bet)
Seat 2: SilencedCrow06 folded before Flop (didn't bet)
Seat 3: AlyCWB folded before Flop (didn't bet)
Seat 4: JRSOMBRIO folded before Flop (didn't bet)
Seat 5: JAPA Z/L folded before Flop (didn't bet)
Seat 6: Eneias27 (button) showed [Jh 9c] and won (210688) with a pair of Nines
Seat 7: GamblerCism (small blind) folded before Flop
Seat 8: b2yq (big blind) showed [Qs Ah] and lost with high card Ace
Seat 9: moitoi87 showed [Ks Ac] and lost with high card Ace



PokerStars Hand #201885773940: Tournament #2634449693, $0.98+$0.12 USD Hold'em No Limit - Level XIV (1800/3600) - 2019/06/30 17:28:36 BRT [2019/06/30 16:28:36 ET]
Table '2634449693 133' 9-max Seat #7 is the button
Seat 1: joaomcneto (31130 in chips) 
Seat 2: SilencedCrow06 (102707 in chips) 
Seat 3: AlyCWB (162618 in chips) 
Seat 4: JRSOMBRIO (92360 in chips) 
Seat 5: JAPA Z/L (277248 in chips) 
Seat 6: Eneias27 (300794 in chips) 
Seat 7: GamblerCism (35496 in chips) 
Seat 9: melmak777 (50000 in chips) out of hand (moved from another table into small blind)
melmak777 will be allowed to play after the button
joaomcneto: posts the ante 360
SilencedCrow06: posts the ante 360
AlyCWB: posts the ante 360
JRSOMBRIO: posts the ante 360
JAPA Z/L: posts the ante 360
Eneias27: posts the ante 360
GamblerCism: posts the ante 360
joaomcneto: posts small blind 1800
SilencedCrow06: posts big blind 3600
*** HOLE CARDS ***
Dealt to AlyCWB [3h 6h]
AlyCWB: folds 
JRSOMBRIO: folds 
JAPA Z/L: folds 
Eneias27: calls 3600
GamblerCism: folds 
joaomcneto: folds 
SilencedCrow06: checks 
*** FLOP *** [2d 6d Kh]
SilencedCrow06: checks 
Eneias27: bets 5760
SilencedCrow06: folds 
Uncalled bet (5760) returned to Eneias27
Eneias27 collected 11520 from pot
Eneias27: doesn't show hand 
*** SUMMARY ***
Total pot 11520 | Rake 0 
Board [2d 6d Kh]
Seat 1: joaomcneto (small blind) folded before Flop
Seat 2: SilencedCrow06 (big blind) folded on the Flop
Seat 3: AlyCWB folded before Flop (didn't bet)
Seat 4: JRSOMBRIO folded before Flop (didn't bet)
Seat 5: JAPA Z/L folded before Flop (didn't bet)
Seat 6: Eneias27 collected (11520)
Seat 7: GamblerCism (button) folded before Flop (didn't bet)



PokerStars Hand #201885792078: Tournament #2634449693, $0.98+$0.12 USD Hold'em No Limit - Level XIV (1800/3600) - 2019/06/30 17:29:02 BRT [2019/06/30 16:29:02 ET]
Table '2634449693 133' 9-max Seat #1 is the button
Seat 1: joaomcneto (28970 in chips) 
Seat 2: SilencedCrow06 (98747 in chips) 
Seat 3: AlyCWB (162258 in chips) 
Seat 4: JRSOMBRIO (92000 in chips) 
Seat 5: JAPA Z/L (276888 in chips) 
Seat 6: Eneias27 (308354 in chips) 
Seat 7: GamblerCism (35136 in chips) 
Seat 8: Mairoula81 (50000 in chips) 
Seat 9: melmak777 (50000 in chips) 
joaomcneto: posts the ante 360
SilencedCrow06: posts the ante 360
AlyCWB: posts the ante 360
JRSOMBRIO: posts the ante 360
JAPA Z/L: posts the ante 360
Eneias27: posts the ante 360
GamblerCism: posts the ante 360
Mairoula81: posts the ante 360
melmak777: posts the ante 360
SilencedCrow06: posts small blind 1800
AlyCWB: posts big blind 3600
*** HOLE CARDS ***
Dealt to AlyCWB [Jc Kh]
JRSOMBRIO: folds 
JAPA Z/L: folds 
Eneias27: folds 
GamblerCism: folds 
Mairoula81: calls 3600
melmak777: folds 
joaomcneto: folds 
SilencedCrow06: folds 
AlyCWB: checks 
*** FLOP *** [6d 8c Kc]
AlyCWB: checks 
Mairoula81: bets 4896
AlyCWB: calls 4896
*** TURN *** [6d 8c Kc] [2c]
AlyCWB: checks 
Mairoula81: checks 
*** RIVER *** [6d 8c Kc 2c] [As]
AlyCWB: checks 
Mairoula81: bets 14400
AlyCWB: calls 14400
*** SHOW DOWN ***
Mairoula81: shows [9c 7c] (a flush, King high)
AlyCWB: mucks hand 
Mairoula81 collected 50832 from pot
*** SUMMARY ***
Total pot 50832 | Rake 0 
Board [6d 8c Kc 2c As]
Seat 1: joaomcneto (button) folded before Flop (didn't bet)
Seat 2: SilencedCrow06 (small blind) folded before Flop
Seat 3: AlyCWB (big blind) mucked [Jc Kh]
Seat 4: JRSOMBRIO folded before Flop (didn't bet)
Seat 5: JAPA Z/L folded before Flop (didn't bet)
Seat 6: Eneias27 folded before Flop (didn't bet)
Seat 7: GamblerCism folded before Flop (didn't bet)
Seat 8: Mairoula81 showed [9c 7c] and won (50832) with a flush, King high
Seat 9: melmak777 folded before Flop (didn't bet)



PokerStars Hand #201885842555: Tournament #2634449693, $0.98+$0.12 USD Hold'em No Limit - Level XIV (1800/3600) - 2019/06/30 17:30:14 BRT [2019/06/30 16:30:14 ET]
Table '2634449693 133' 9-max Seat #2 is the button
Seat 1: joaomcneto (28610 in chips) 
Seat 2: SilencedCrow06 (96587 in chips) 
Seat 3: AlyCWB (139002 in chips) 
Seat 4: JRSOMBRIO (91640 in chips) 
Seat 5: JAPA Z/L (276528 in chips) 
Seat 6: Eneias27 (307994 in chips) 
Seat 7: GamblerCism (34776 in chips) 
Seat 8: Mairoula81 (77576 in chips) 
Seat 9: melmak777 (49640 in chips) 
joaomcneto: posts the ante 360
SilencedCrow06: posts the ante 360
AlyCWB: posts the ante 360
JRSOMBRIO: posts the ante 360
JAPA Z/L: posts the ante 360
Eneias27: posts the ante 360
GamblerCism: posts the ante 360
Mairoula81: posts the ante 360
melmak777: posts the ante 360
AlyCWB: posts small blind 1800
JRSOMBRIO: posts big blind 3600
*** HOLE CARDS ***
Dealt to AlyCWB [5c Jd]
JAPA Z/L: folds 
Eneias27: folds 
GamblerCism: raises 30816 to 34416 and is all-in
Mairoula81: folds 
melmak777: folds 
joaomcneto: folds 
SilencedCrow06: folds 
AlyCWB: folds 
JRSOMBRIO: folds 
Uncalled bet (30816) returned to GamblerCism
GamblerCism collected 12240 from pot
GamblerCism: doesn't show hand 
*** SUMMARY ***
Total pot 12240 | Rake 0 
Seat 1: joaomcneto folded before Flop (didn't bet)
Seat 2: SilencedCrow06 (button) folded before Flop (didn't bet)
Seat 3: AlyCWB (small blind) folded before Flop
Seat 4: JRSOMBRIO (big blind) folded before Flop
Seat 5: JAPA Z/L folded before Flop (didn't bet)
Seat 6: Eneias27 folded before Flop (didn't bet)
Seat 7: GamblerCism collected (12240)
Seat 8: Mairoula81 folded before Flop (didn't bet)
Seat 9: melmak777 folded before Flop (didn't bet)



PokerStars Hand #201885856945: Tournament #2634449693, $0.98+$0.12 USD Hold'em No Limit - Level XIV (1800/3600) - 2019/06/30 17:30:35 BRT [2019/06/30 16:30:35 ET]
Table '2634449693 133' 9-max Seat #3 is the button
Seat 1: joaomcneto (28250 in chips) 
Seat 2: SilencedCrow06 (96227 in chips) 
Seat 3: AlyCWB (136842 in chips) 
Seat 4: JRSOMBRIO (87680 in chips) 
Seat 5: JAPA Z/L (276168 in chips) 
Seat 6: Eneias27 (307634 in chips) 
Seat 7: GamblerCism (43056 in chips) 
Seat 8: Mairoula81 (77216 in chips) 
Seat 9: melmak777 (49280 in chips) 
joaomcneto: posts the ante 360
SilencedCrow06: posts the ante 360
AlyCWB: posts the ante 360
JRSOMBRIO: posts the ante 360
JAPA Z/L: posts the ante 360
Eneias27: posts the ante 360
GamblerCism: posts the ante 360
Mairoula81: posts the ante 360
melmak777: posts the ante 360
JRSOMBRIO: posts small blind 1800
JAPA Z/L: posts big blind 3600
*** HOLE CARDS ***
Dealt to AlyCWB [6d Qc]
Eneias27: folds 
GamblerCism: folds 
Mairoula81: folds 
melmak777: folds 
joaomcneto: folds 
SilencedCrow06: folds 
AlyCWB: raises 3600 to 7200
JRSOMBRIO: folds 
JAPA Z/L: calls 3600
*** FLOP *** [Qd Td Jd]
JAPA Z/L: checks 
AlyCWB: bets 7200
JAPA Z/L: calls 7200
*** TURN *** [Qd Td Jd] [Ts]
JAPA Z/L: checks 
AlyCWB: checks 
*** RIVER *** [Qd Td Jd Ts] [6s]
JAPA Z/L: checks 
AlyCWB: checks 
*** SHOW DOWN ***
JAPA Z/L: shows [2d Kh] (a pair of Tens)
AlyCWB: shows [6d Qc] (two pair, Queens and Tens)
AlyCWB collected 33840 from pot
*** SUMMARY ***
Total pot 33840 | Rake 0 
Board [Qd Td Jd Ts 6s]
Seat 1: joaomcneto folded before Flop (didn't bet)
Seat 2: SilencedCrow06 folded before Flop (didn't bet)
Seat 3: AlyCWB (button) showed [6d Qc] and won (33840) with two pair, Queens and Tens
Seat 4: JRSOMBRIO (small blind) folded before Flop
Seat 5: JAPA Z/L (big blind) showed [2d Kh] and lost with a pair of Tens
Seat 6: Eneias27 folded before Flop (didn't bet)
Seat 7: GamblerCism folded before Flop (didn't bet)
Seat 8: Mairoula81 folded before Flop (didn't bet)
Seat 9: melmak777 folded before Flop (didn't bet)



PokerStars Hand #201885904640: Tournament #2634449693, $0.98+$0.12 USD Hold'em No Limit - Level XIV (1800/3600) - 2019/06/30 17:31:44 BRT [2019/06/30 16:31:44 ET]
Table '2634449693 133' 9-max Seat #4 is the button
Seat 1: joaomcneto (27890 in chips) 
Seat 2: SilencedCrow06 (95867 in chips) 
Seat 3: AlyCWB (155922 in chips) 
Seat 4: JRSOMBRIO (85520 in chips) 
Seat 5: JAPA Z/L (261408 in chips) 
Seat 6: Eneias27 (307274 in chips) 
Seat 7: GamblerCism (42696 in chips) 
Seat 8: Mairoula81 (76856 in chips) 
Seat 9: melmak777 (48920 in chips) 
joaomcneto: posts the ante 360
SilencedCrow06: posts the ante 360
AlyCWB: posts the ante 360
JRSOMBRIO: posts the ante 360
JAPA Z/L: posts the ante 360
Eneias27: posts the ante 360
GamblerCism: posts the ante 360
Mairoula81: posts the ante 360
melmak777: posts the ante 360
JAPA Z/L: posts small blind 1800
Eneias27: posts big blind 3600
*** HOLE CARDS ***
Dealt to AlyCWB [2d 6s]
GamblerCism: folds 
Mairoula81: calls 3600
melmak777: folds 
joaomcneto: folds 
SilencedCrow06: folds 
AlyCWB: folds 
JRSOMBRIO: folds 
JAPA Z/L: calls 1800
Eneias27: raises 7200 to 10800
Mairoula81: calls 7200
JAPA Z/L: calls 7200
*** FLOP *** [9s Kd Jh]
JAPA Z/L: checks 
Eneias27: bets 17820
Mairoula81: folds 
JAPA Z/L: calls 17820
*** TURN *** [9s Kd Jh] [6c]
JAPA Z/L: checks 
Eneias27: checks 
*** RIVER *** [9s Kd Jh 6c] [Qh]
JAPA Z/L: bets 57600
Eneias27: calls 57600
*** SHOW DOWN ***
JAPA Z/L: shows [Ac Td] (a straight, Ten to Ace)
Eneias27: mucks hand 
JAPA Z/L collected 186480 from pot
*** SUMMARY ***
Total pot 186480 | Rake 0 
Board [9s Kd Jh 6c Qh]
Seat 1: joaomcneto folded before Flop (didn't bet)
Seat 2: SilencedCrow06 folded before Flop (didn't bet)
Seat 3: AlyCWB folded before Flop (didn't bet)
Seat 4: JRSOMBRIO (button) folded before Flop (didn't bet)
Seat 5: JAPA Z/L (small blind) showed [Ac Td] and won (186480) with a straight, Ten to Ace
Seat 6: Eneias27 (big blind) mucked [Kc Ts]
Seat 7: GamblerCism folded before Flop (didn't bet)
Seat 8: Mairoula81 folded on the Flop
Seat 9: melmak777 folded before Flop (didn't bet)



PokerStars Hand #201885955165: Tournament #2634449693, $0.98+$0.12 USD Hold'em No Limit - Level XIV (1800/3600) - 2019/06/30 17:32:57 BRT [2019/06/30 16:32:57 ET]
Table '2634449693 133' 9-max Seat #5 is the button
Seat 1: joaomcneto (27530 in chips) 
Seat 2: SilencedCrow06 (95507 in chips) 
Seat 3: AlyCWB (155562 in chips) 
Seat 4: JRSOMBRIO (85160 in chips) 
Seat 5: JAPA Z/L (361308 in chips) 
Seat 6: Eneias27 (220694 in chips) 
Seat 7: GamblerCism (42336 in chips) 
Seat 8: Mairoula81 (65696 in chips) 
Seat 9: melmak777 (48560 in chips) 
joaomcneto: posts the ante 360
SilencedCrow06: posts the ante 360
AlyCWB: posts the ante 360
JRSOMBRIO: posts the ante 360
JAPA Z/L: posts the ante 360
Eneias27: posts the ante 360
GamblerCism: posts the ante 360
Mairoula81: posts the ante 360
melmak777: posts the ante 360
Eneias27: posts small blind 1800
GamblerCism: posts big blind 3600
*** HOLE CARDS ***
Dealt to AlyCWB [Js 4s]
Mairoula81: folds 
melmak777: folds 
joaomcneto: folds 
SilencedCrow06: folds 
AlyCWB: folds 
JRSOMBRIO: folds 
JAPA Z/L: folds 
Eneias27: calls 1800
GamblerCism: checks 
*** FLOP *** [Kd 6s 3c]
Eneias27: checks 
GamblerCism: checks 
*** TURN *** [Kd 6s 3c] [9h]
Eneias27: checks 
GamblerCism: checks 
*** RIVER *** [Kd 6s 3c 9h] [Ah]
Eneias27: checks 
GamblerCism: checks 
*** SHOW DOWN ***
Eneias27: shows [Qs 3s] (a pair of Threes)
GamblerCism: mucks hand 
Eneias27 collected 10440 from pot
*** SUMMARY ***
Total pot 10440 | Rake 0 
Board [Kd 6s 3c 9h Ah]
Seat 1: joaomcneto folded before Flop (didn't bet)
Seat 2: SilencedCrow06 folded before Flop (didn't bet)
Seat 3: AlyCWB folded before Flop (didn't bet)
Seat 4: JRSOMBRIO folded before Flop (didn't bet)
Seat 5: JAPA Z/L (button) folded before Flop (didn't bet)
Seat 6: Eneias27 (small blind) showed [Qs 3s] and won (10440) with a pair of Threes
Seat 7: GamblerCism (big blind) mucked [7s 4c]
Seat 8: Mairoula81 folded before Flop (didn't bet)
Seat 9: melmak777 folded before Flop (didn't bet)



PokerStars Hand #201885986965: Tournament #2634449693, $0.98+$0.12 USD Hold'em No Limit - Level XV (2000/4000) - 2019/06/30 17:33:43 BRT [2019/06/30 16:33:43 ET]
Table '2634449693 133' 9-max Seat #6 is the button
Seat 1: joaomcneto (27170 in chips) 
Seat 2: SilencedCrow06 (95147 in chips) 
Seat 3: AlyCWB (155202 in chips) 
Seat 4: JRSOMBRIO (84800 in chips) 
Seat 5: JAPA Z/L (360948 in chips) 
Seat 6: Eneias27 (227174 in chips) 
Seat 7: GamblerCism (38376 in chips) 
Seat 8: Mairoula81 (65336 in chips) 
Seat 9: melmak777 (48200 in chips) 
joaomcneto: posts the ante 400
SilencedCrow06: posts the ante 400
AlyCWB: posts the ante 400
JRSOMBRIO: posts the ante 400
JAPA Z/L: posts the ante 400
Eneias27: posts the ante 400
GamblerCism: posts the ante 400
Mairoula81: posts the ante 400
melmak777: posts the ante 400
GamblerCism: posts small blind 2000
Mairoula81: posts big blind 4000
*** HOLE CARDS ***
Dealt to AlyCWB [Qh Kd]
melmak777: folds 
joaomcneto: folds 
SilencedCrow06: folds 
AlyCWB: raises 4000 to 8000
JRSOMBRIO: folds 
JAPA Z/L: folds 
Eneias27: calls 8000
GamblerCism: folds 
Mairoula81: folds 
*** FLOP *** [2s 2d Jh]
AlyCWB: checks 
Eneias27: checks 
*** TURN *** [2s 2d Jh] [4h]
AlyCWB: bets 8000
Eneias27: folds 
Uncalled bet (8000) returned to AlyCWB
AlyCWB collected 25600 from pot
*** SUMMARY ***
Total pot 25600 | Rake 0 
Board [2s 2d Jh 4h]
Seat 1: joaomcneto folded before Flop (didn't bet)
Seat 2: SilencedCrow06 folded before Flop (didn't bet)
Seat 3: AlyCWB collected (25600)
Seat 4: JRSOMBRIO folded before Flop (didn't bet)
Seat 5: JAPA Z/L folded before Flop (didn't bet)
Seat 6: Eneias27 (button) folded on the Turn
Seat 7: GamblerCism (small blind) folded before Flop
Seat 8: Mairoula81 (big blind) folded before Flop
Seat 9: melmak777 folded before Flop (didn't bet)



PokerStars Hand #201886040678: Tournament #2634449693, $0.98+$0.12 USD Hold'em No Limit - Level XV (2000/4000) - 2019/06/30 17:35:03 BRT [2019/06/30 16:35:03 ET]
Table '2634449693 133' 9-max Seat #7 is the button
Seat 1: joaomcneto (26770 in chips) 
Seat 2: SilencedCrow06 (94747 in chips) 
Seat 3: AlyCWB (172402 in chips) 
Seat 4: JRSOMBRIO (84400 in chips) 
Seat 5: JAPA Z/L (360548 in chips) 
Seat 6: Eneias27 (218774 in chips) 
Seat 7: GamblerCism (35976 in chips) 
Seat 8: Mairoula81 (60936 in chips) 
Seat 9: melmak777 (47800 in chips) 
joaomcneto: posts the ante 400
SilencedCrow06: posts the ante 400
AlyCWB: posts the ante 400
JRSOMBRIO: posts the ante 400
JAPA Z/L: posts the ante 400
Eneias27: posts the ante 400
GamblerCism: posts the ante 400
Mairoula81: posts the ante 400
melmak777: posts the ante 400
Mairoula81: posts small blind 2000
melmak777: posts big blind 4000
*** HOLE CARDS ***
Dealt to AlyCWB [Jd 8d]
joaomcneto: folds 
SilencedCrow06: folds 
AlyCWB: folds 
JRSOMBRIO: folds 
JAPA Z/L: raises 4000 to 8000
Eneias27: calls 8000
GamblerCism: folds 
Mairoula81: folds 
melmak777: calls 4000
*** FLOP *** [Js 5h 7c]
melmak777: checks 
JAPA Z/L: checks 
Eneias27: checks 
*** TURN *** [Js 5h 7c] [Ts]
melmak777: checks 
JAPA Z/L: checks 
Eneias27: checks 
*** RIVER *** [Js 5h 7c Ts] [4d]
melmak777: checks 
JAPA Z/L: checks 
Eneias27: bets 14800
melmak777: folds 
JAPA Z/L: folds 
Uncalled bet (14800) returned to Eneias27
Eneias27 collected 29600 from pot
Eneias27: doesn't show hand 
*** SUMMARY ***
Total pot 29600 | Rake 0 
Board [Js 5h 7c Ts 4d]
Seat 1: joaomcneto folded before Flop (didn't bet)
Seat 2: SilencedCrow06 folded before Flop (didn't bet)
Seat 3: AlyCWB folded before Flop (didn't bet)
Seat 4: JRSOMBRIO folded before Flop (didn't bet)
Seat 5: JAPA Z/L folded on the River
Seat 6: Eneias27 collected (29600)
Seat 7: GamblerCism (button) folded before Flop (didn't bet)
Seat 8: Mairoula81 (small blind) folded before Flop
Seat 9: melmak777 (big blind) folded on the River



PokerStars Hand #201886105225: Tournament #2634449693, $0.98+$0.12 USD Hold'em No Limit - Level XV (2000/4000) - 2019/06/30 17:36:37 BRT [2019/06/30 16:36:37 ET]
Table '2634449693 133' 9-max Seat #8 is the button
Seat 1: joaomcneto (26370 in chips) 
Seat 2: SilencedCrow06 (94347 in chips) 
Seat 3: AlyCWB (172002 in chips) 
Seat 4: JRSOMBRIO (84000 in chips) 
Seat 5: JAPA Z/L (352148 in chips) 
Seat 6: Eneias27 (239974 in chips) 
Seat 7: GamblerCism (35576 in chips) 
Seat 8: Mairoula81 (58536 in chips) 
Seat 9: melmak777 (39400 in chips) 
joaomcneto: posts the ante 400
SilencedCrow06: posts the ante 400
AlyCWB: posts the ante 400
JRSOMBRIO: posts the ante 400
JAPA Z/L: posts the ante 400
Eneias27: posts the ante 400
GamblerCism: posts the ante 400
Mairoula81: posts the ante 400
melmak777: posts the ante 400
melmak777: posts small blind 2000
joaomcneto: posts big blind 4000
*** HOLE CARDS ***
Dealt to AlyCWB [4d 5c]
SilencedCrow06: raises 5960 to 9960
AlyCWB: folds 
JRSOMBRIO: calls 9960
JAPA Z/L: folds 
Eneias27: folds 
GamblerCism: folds 
Mairoula81: folds 
melmak777: calls 7960
joaomcneto: folds 
*** FLOP *** [2h 3h Ad]
melmak777: checks 
SilencedCrow06: bets 20989
JRSOMBRIO: folds 
melmak777: folds 
Uncalled bet (20989) returned to SilencedCrow06
SilencedCrow06 collected 37480 from pot
*** SUMMARY ***
Total pot 37480 | Rake 0 
Board [2h 3h Ad]
Seat 1: joaomcneto (big blind) folded before Flop
Seat 2: SilencedCrow06 collected (37480)
Seat 3: AlyCWB folded before Flop (didn't bet)
Seat 4: JRSOMBRIO folded on the Flop
Seat 5: JAPA Z/L folded before Flop (didn't bet)
Seat 6: Eneias27 folded before Flop (didn't bet)
Seat 7: GamblerCism folded before Flop (didn't bet)
Seat 8: Mairoula81 (button) folded before Flop (didn't bet)
Seat 9: melmak777 (small blind) folded on the Flop



PokerStars Hand #201886167738: Tournament #2634449693, $0.98+$0.12 USD Hold'em No Limit - Level XVI (2500/5000) - 2019/06/30 17:38:09 BRT [2019/06/30 16:38:09 ET]
Table '2634449693 133' 9-max Seat #9 is the button
Seat 1: joaomcneto (21970 in chips) 
Seat 2: SilencedCrow06 (121467 in chips) 
Seat 3: AlyCWB (171602 in chips) 
Seat 4: JRSOMBRIO (73640 in chips) 
Seat 5: JAPA Z/L (351748 in chips) 
Seat 6: Eneias27 (239574 in chips) 
Seat 7: GamblerCism (35176 in chips) 
Seat 8: Mairoula81 (58136 in chips) 
Seat 9: melmak777 (29040 in chips) 
joaomcneto: posts the ante 500
SilencedCrow06: posts the ante 500
AlyCWB: posts the ante 500
JRSOMBRIO: posts the ante 500
JAPA Z/L: posts the ante 500
Eneias27: posts the ante 500
GamblerCism: posts the ante 500
Mairoula81: posts the ante 500
melmak777: posts the ante 500
joaomcneto: posts small blind 2500
SilencedCrow06: posts big blind 5000
*** HOLE CARDS ***
Dealt to AlyCWB [2s 9h]
AlyCWB: folds 
JRSOMBRIO: folds 
JAPA Z/L: raises 5000 to 10000
Eneias27: calls 10000
GamblerCism: folds 
Mairoula81: folds 
melmak777: folds 
joaomcneto: folds 
SilencedCrow06: folds 
*** FLOP *** [8c 4s Ts]
JAPA Z/L: bets 16000
Eneias27: folds 
Uncalled bet (16000) returned to JAPA Z/L
JAPA Z/L collected 32000 from pot
*** SUMMARY ***
Total pot 32000 | Rake 0 
Board [8c 4s Ts]
Seat 1: joaomcneto (small blind) folded before Flop
Seat 2: SilencedCrow06 (big blind) folded before Flop
Seat 3: AlyCWB folded before Flop (didn't bet)
Seat 4: JRSOMBRIO folded before Flop (didn't bet)
Seat 5: JAPA Z/L collected (32000)
Seat 6: Eneias27 folded on the Flop
Seat 7: GamblerCism folded before Flop (didn't bet)
Seat 8: Mairoula81 folded before Flop (didn't bet)
Seat 9: melmak777 (button) folded before Flop (didn't bet)



PokerStars Hand #201886202247: Tournament #2634449693, $0.98+$0.12 USD Hold'em No Limit - Level XVI (2500/5000) - 2019/06/30 17:39:00 BRT [2019/06/30 16:39:00 ET]
Table '2634449693 133' 9-max Seat #1 is the button
Seat 1: joaomcneto (18970 in chips) 
Seat 2: SilencedCrow06 (115967 in chips) 
Seat 3: AlyCWB (171102 in chips) 
Seat 4: JRSOMBRIO (73140 in chips) 
Seat 5: JAPA Z/L (373248 in chips) 
Seat 6: Eneias27 (229074 in chips) 
Seat 7: GamblerCism (34676 in chips) 
Seat 8: Mairoula81 (57636 in chips) 
Seat 9: melmak777 (28540 in chips) 
joaomcneto: posts the ante 500
SilencedCrow06: posts the ante 500
AlyCWB: posts the ante 500
JRSOMBRIO: posts the ante 500
JAPA Z/L: posts the ante 500
Eneias27: posts the ante 500
GamblerCism: posts the ante 500
Mairoula81: posts the ante 500
melmak777: posts the ante 500
SilencedCrow06: posts small blind 2500
AlyCWB: posts big blind 5000
*** HOLE CARDS ***
Dealt to AlyCWB [5s 4c]
JRSOMBRIO: folds 
JAPA Z/L: folds 
Eneias27: calls 5000
GamblerCism: raises 29176 to 34176 and is all-in
Mairoula81: folds 
melmak777: folds 
joaomcneto: calls 18470 and is all-in
SilencedCrow06: folds 
AlyCWB: folds 
Eneias27: folds 
Uncalled bet (15706) returned to GamblerCism
*** FLOP *** [8c Qd 7c]
*** TURN *** [8c Qd 7c] [6d]
*** RIVER *** [8c Qd 7c 6d] [Kc]
*** SHOW DOWN ***
GamblerCism: shows [9c Ad] (high card Ace)
joaomcneto: shows [As Kh] (a pair of Kings)
joaomcneto collected 53940 from pot
*** SUMMARY ***
Total pot 53940 | Rake 0 
Board [8c Qd 7c 6d Kc]
Seat 1: joaomcneto (button) showed [As Kh] and won (53940) with a pair of Kings
Seat 2: SilencedCrow06 (small blind) folded before Flop
Seat 3: AlyCWB (big blind) folded before Flop
Seat 4: JRSOMBRIO folded before Flop (didn't bet)
Seat 5: JAPA Z/L folded before Flop (didn't bet)
Seat 6: Eneias27 folded before Flop
Seat 7: GamblerCism showed [9c Ad] and lost with high card Ace
Seat 8: Mairoula81 folded before Flop (didn't bet)
Seat 9: melmak777 folded before Flop (didn't bet)



PokerStars Hand #201886232729: Tournament #2634449693, $0.98+$0.12 USD Hold'em No Limit - Level XVI (2500/5000) - 2019/06/30 17:39:45 BRT [2019/06/30 16:39:45 ET]
Table '2634449693 133' 9-max Seat #2 is the button
Seat 1: joaomcneto (53940 in chips) 
Seat 2: SilencedCrow06 (112967 in chips) 
Seat 3: AlyCWB (165602 in chips) 
Seat 4: JRSOMBRIO (72640 in chips) 
Seat 5: JAPA Z/L (372748 in chips) 
Seat 6: Eneias27 (223574 in chips) 
Seat 7: GamblerCism (15706 in chips) 
Seat 8: Mairoula81 (57136 in chips) 
Seat 9: melmak777 (28040 in chips) 
joaomcneto: posts the ante 500
SilencedCrow06: posts the ante 500
AlyCWB: posts the ante 500
JRSOMBRIO: posts the ante 500
JAPA Z/L: posts the ante 500
Eneias27: posts the ante 500
GamblerCism: posts the ante 500
Mairoula81: posts the ante 500
melmak777: posts the ante 500
AlyCWB: posts small blind 2500
JRSOMBRIO: posts big blind 5000
*** HOLE CARDS ***
Dealt to AlyCWB [4h 5d]
JAPA Z/L: folds 
Eneias27: calls 5000
GamblerCism: folds 
Mairoula81: folds 
melmak777: folds 
joaomcneto: folds 
SilencedCrow06: folds 
AlyCWB: folds 
JRSOMBRIO: checks 
*** FLOP *** [3d 4s Jh]
JRSOMBRIO: checks 
Eneias27: checks 
*** TURN *** [3d 4s Jh] [Th]
JRSOMBRIO: bets 5000
Eneias27: calls 5000
*** RIVER *** [3d 4s Jh Th] [5s]
JRSOMBRIO: bets 27000
Eneias27: folds 
Uncalled bet (27000) returned to JRSOMBRIO
JRSOMBRIO collected 27000 from pot
*** SUMMARY ***
Total pot 27000 | Rake 0 
Board [3d 4s Jh Th 5s]
Seat 1: joaomcneto folded before Flop (didn't bet)
Seat 2: SilencedCrow06 (button) folded before Flop (didn't bet)
Seat 3: AlyCWB (small blind) folded before Flop
Seat 4: JRSOMBRIO (big blind) collected (27000)
Seat 5: JAPA Z/L folded before Flop (didn't bet)
Seat 6: Eneias27 folded on the River
Seat 7: GamblerCism folded before Flop (didn't bet)
Seat 8: Mairoula81 folded before Flop (didn't bet)
Seat 9: melmak777 folded before Flop (didn't bet)



PokerStars Hand #201886272802: Tournament #2634449693, $0.98+$0.12 USD Hold'em No Limit - Level XVI (2500/5000) - 2019/06/30 17:40:45 BRT [2019/06/30 16:40:45 ET]
Table '2634449693 133' 9-max Seat #3 is the button
Seat 1: joaomcneto (53440 in chips) 
Seat 2: SilencedCrow06 (112467 in chips) 
Seat 3: AlyCWB (162602 in chips) 
Seat 4: JRSOMBRIO (89140 in chips) 
Seat 5: JAPA Z/L (372248 in chips) 
Seat 6: Eneias27 (213074 in chips) 
Seat 7: GamblerCism (15206 in chips) 
Seat 8: Mairoula81 (56636 in chips) 
Seat 9: melmak777 (27540 in chips) 
joaomcneto: posts the ante 500
SilencedCrow06: posts the ante 500
AlyCWB: posts the ante 500
JRSOMBRIO: posts the ante 500
JAPA Z/L: posts the ante 500
Eneias27: posts the ante 500
GamblerCism: posts the ante 500
Mairoula81: posts the ante 500
melmak777: posts the ante 500
JRSOMBRIO: posts small blind 2500
JAPA Z/L: posts big blind 5000
*** HOLE CARDS ***
Dealt to AlyCWB [Qh Kc]
Eneias27: calls 5000
GamblerCism: folds 
Mairoula81: folds 
melmak777: folds 
joaomcneto: folds 
SilencedCrow06: raises 8700 to 13700
AlyCWB: folds 
JRSOMBRIO: folds 
JAPA Z/L: calls 8700
Eneias27: calls 8700
*** FLOP *** [8c Ks Tc]
JAPA Z/L: checks 
Eneias27: checks 
SilencedCrow06: checks 
*** TURN *** [8c Ks Tc] [Qd]
JAPA Z/L: checks 
Eneias27: bets 24050
SilencedCrow06: folds 
JAPA Z/L: calls 24050
*** RIVER *** [8c Ks Tc Qd] [6s]
JAPA Z/L: checks 
Eneias27: checks 
*** SHOW DOWN ***
JAPA Z/L: shows [Ts Ad] (a pair of Tens)
Eneias27: mucks hand 
JAPA Z/L collected 96200 from pot
*** SUMMARY ***
Total pot 96200 | Rake 0 
Board [8c Ks Tc Qd 6s]
Seat 1: joaomcneto folded before Flop (didn't bet)
Seat 2: SilencedCrow06 folded on the Turn
Seat 3: AlyCWB (button) folded before Flop (didn't bet)
Seat 4: JRSOMBRIO (small blind) folded before Flop
Seat 5: JAPA Z/L (big blind) showed [Ts Ad] and won (96200) with a pair of Tens
Seat 6: Eneias27 mucked [Th Jc]
Seat 7: GamblerCism folded before Flop (didn't bet)
Seat 8: Mairoula81 folded before Flop (didn't bet)
Seat 9: melmak777 folded before Flop (didn't bet)



PokerStars Hand #201886337054: Tournament #2634449693, $0.98+$0.12 USD Hold'em No Limit - Level XVI (2500/5000) - 2019/06/30 17:42:20 BRT [2019/06/30 16:42:20 ET]
Table '2634449693 133' 9-max Seat #4 is the button
Seat 1: joaomcneto (52940 in chips) 
Seat 2: SilencedCrow06 (98267 in chips) 
Seat 3: AlyCWB (162102 in chips) 
Seat 4: JRSOMBRIO (86140 in chips) 
Seat 5: JAPA Z/L (430198 in chips) 
Seat 6: Eneias27 (174824 in chips) 
Seat 7: GamblerCism (14706 in chips) 
Seat 8: Mairoula81 (56136 in chips) 
Seat 9: melmak777 (27040 in chips) 
joaomcneto: posts the ante 500
SilencedCrow06: posts the ante 500
AlyCWB: posts the ante 500
JRSOMBRIO: posts the ante 500
JAPA Z/L: posts the ante 500
Eneias27: posts the ante 500
GamblerCism: posts the ante 500
Mairoula81: posts the ante 500
melmak777: posts the ante 500
JAPA Z/L: posts small blind 2500
Eneias27: posts big blind 5000
*** HOLE CARDS ***
Dealt to AlyCWB [2d 9c]
GamblerCism: raises 9206 to 14206 and is all-in
Mairoula81: folds 
melmak777: folds 
joaomcneto: folds 
SilencedCrow06: folds 
AlyCWB: folds 
JRSOMBRIO: folds 
JAPA Z/L: folds 
Eneias27: calls 9206
*** FLOP *** [3h Ks Js]
*** TURN *** [3h Ks Js] [Qs]
*** RIVER *** [3h Ks Js Qs] [Ac]
*** SHOW DOWN ***
Eneias27: shows [7c 5s] (high card Ace)
GamblerCism: shows [6d 4d] (high card Ace - lower kicker)
Eneias27 collected 35412 from pot
GamblerCism finished the tournament in 1166th place
*** SUMMARY ***
Total pot 35412 | Rake 0 
Board [3h Ks Js Qs Ac]
Seat 1: joaomcneto folded before Flop (didn't bet)
Seat 2: SilencedCrow06 folded before Flop (didn't bet)
Seat 3: AlyCWB folded before Flop (didn't bet)
Seat 4: JRSOMBRIO (button) folded before Flop (didn't bet)
Seat 5: JAPA Z/L (small blind) folded before Flop
Seat 6: Eneias27 (big blind) showed [7c 5s] and won (35412) with high card Ace
Seat 7: GamblerCism showed [6d 4d] and lost with high card Ace
Seat 8: Mairoula81 folded before Flop (didn't bet)
Seat 9: melmak777 folded before Flop (didn't bet)



PokerStars Hand #201886372771: Tournament #2634449693, $0.98+$0.12 USD Hold'em No Limit - Level XVII (3000/6000) - 2019/06/30 17:43:13 BRT [2019/06/30 16:43:13 ET]
Table '2634449693 133' 9-max Seat #5 is the button
Seat 1: joaomcneto (52440 in chips) 
Seat 2: SilencedCrow06 (97767 in chips) 
Seat 3: AlyCWB (161602 in chips) 
Seat 4: JRSOMBRIO (85640 in chips) 
Seat 5: JAPA Z/L (427198 in chips) 
Seat 6: Eneias27 (195530 in chips) 
Seat 8: Mairoula81 (55636 in chips) 
Seat 9: melmak777 (26540 in chips) 
joaomcneto: posts the ante 600
SilencedCrow06: posts the ante 600
AlyCWB: posts the ante 600
JRSOMBRIO: posts the ante 600
JAPA Z/L: posts the ante 600
Eneias27: posts the ante 600
Mairoula81: posts the ante 600
melmak777: posts the ante 600
Eneias27: posts small blind 3000
Mairoula81: posts big blind 6000
*** HOLE CARDS ***
Dealt to AlyCWB [Qc 4s]
melmak777: folds 
joaomcneto: folds 
SilencedCrow06: folds 
AlyCWB: folds 
JRSOMBRIO: folds 
JAPA Z/L: folds 
Eneias27: calls 3000
Mairoula81: raises 49036 to 55036 and is all-in
Eneias27: folds 
Uncalled bet (49036) returned to Mairoula81
Mairoula81 collected 16800 from pot
Mairoula81: doesn't show hand 
*** SUMMARY ***
Total pot 16800 | Rake 0 
Seat 1: joaomcneto folded before Flop (didn't bet)
Seat 2: SilencedCrow06 folded before Flop (didn't bet)
Seat 3: AlyCWB folded before Flop (didn't bet)
Seat 4: JRSOMBRIO folded before Flop (didn't bet)
Seat 5: JAPA Z/L (button) folded before Flop (didn't bet)
Seat 6: Eneias27 (small blind) folded before Flop
Seat 8: Mairoula81 (big blind) collected (16800)
Seat 9: melmak777 folded before Flop (didn't bet)



PokerStars Hand #201886393755: Tournament #2634449693, $0.98+$0.12 USD Hold'em No Limit - Level XVII (3000/6000) - 2019/06/30 17:43:44 BRT [2019/06/30 16:43:44 ET]
Table '2634449693 133' 9-max Seat #6 is the button
Seat 1: joaomcneto (51840 in chips) 
Seat 2: SilencedCrow06 (97167 in chips) 
Seat 3: AlyCWB (161002 in chips) 
Seat 4: JRSOMBRIO (85040 in chips) 
Seat 5: JAPA Z/L (426598 in chips) 
Seat 6: Eneias27 (188930 in chips) 
Seat 7: Legijon (298091 in chips) out of hand (moved from another table into small blind)
Seat 8: Mairoula81 (65836 in chips) 
Seat 9: melmak777 (25940 in chips) 
Legijon will be allowed to play after the button
joaomcneto: posts the ante 600
SilencedCrow06: posts the ante 600
AlyCWB: posts the ante 600
JRSOMBRIO: posts the ante 600
JAPA Z/L: posts the ante 600
Eneias27: posts the ante 600
Mairoula81: posts the ante 600
melmak777: posts the ante 600
Mairoula81: posts small blind 3000
melmak777: posts big blind 6000
*** HOLE CARDS ***
Dealt to AlyCWB [Th 9d]
joaomcneto: folds 
SilencedCrow06: folds 
AlyCWB: folds 
JRSOMBRIO: folds 
JAPA Z/L: folds 
Eneias27: calls 6000
Mairoula81: folds 
melmak777: checks 
*** FLOP *** [Qs 9c 8s]
melmak777: checks 
Eneias27: checks 
*** TURN *** [Qs 9c 8s] [5h]
melmak777: bets 9900
Eneias27: folds 
Uncalled bet (9900) returned to melmak777
melmak777 collected 19800 from pot
melmak777: doesn't show hand 
*** SUMMARY ***
Total pot 19800 | Rake 0 
Board [Qs 9c 8s 5h]
Seat 1: joaomcneto folded before Flop (didn't bet)
Seat 2: SilencedCrow06 folded before Flop (didn't bet)
Seat 3: AlyCWB folded before Flop (didn't bet)
Seat 4: JRSOMBRIO folded before Flop (didn't bet)
Seat 5: JAPA Z/L folded before Flop (didn't bet)
Seat 6: Eneias27 (button) folded on the Turn
Seat 8: Mairoula81 (small blind) folded before Flop
Seat 9: melmak777 (big blind) collected (19800)



PokerStars Hand #201886431596: Tournament #2634449693, $0.98+$0.12 USD Hold'em No Limit - Level XVII (3000/6000) - 2019/06/30 17:44:40 BRT [2019/06/30 16:44:40 ET]
Table '2634449693 133' 9-max Seat #8 is the button
Seat 1: joaomcneto (51240 in chips) 
Seat 2: SilencedCrow06 (96567 in chips) 
Seat 3: AlyCWB (160402 in chips) 
Seat 4: JRSOMBRIO (84440 in chips) 
Seat 5: JAPA Z/L (425998 in chips) 
Seat 6: Eneias27 (182330 in chips) 
Seat 7: Legijon (298091 in chips) 
Seat 8: Mairoula81 (62236 in chips) 
Seat 9: melmak777 (39140 in chips) 
joaomcneto: posts the ante 600
SilencedCrow06: posts the ante 600
AlyCWB: posts the ante 600
JRSOMBRIO: posts the ante 600
JAPA Z/L: posts the ante 600
Eneias27: posts the ante 600
Legijon: posts the ante 600
Mairoula81: posts the ante 600
melmak777: posts the ante 600
melmak777: posts small blind 3000
joaomcneto: posts big blind 6000
*** HOLE CARDS ***
Dealt to AlyCWB [Js Td]
SilencedCrow06: folds 
AlyCWB: folds 
JRSOMBRIO: folds 
JAPA Z/L: folds 
Eneias27: calls 6000
Legijon: folds 
Mairoula81: folds 
melmak777: folds 
joaomcneto: checks 
*** FLOP *** [4s Ah 7s]
joaomcneto: bets 10200
Eneias27: calls 10200
*** TURN *** [4s Ah 7s] [Th]
joaomcneto: bets 34440 and is all-in
Eneias27: calls 34440
*** RIVER *** [4s Ah 7s Th] [Qc]
*** SHOW DOWN ***
joaomcneto: shows [9h Ac] (a pair of Aces)
Eneias27: shows [6d As] (a pair of Aces - lower kicker)
joaomcneto collected 109680 from pot
*** SUMMARY ***
Total pot 109680 | Rake 0 
Board [4s Ah 7s Th Qc]
Seat 1: joaomcneto (big blind) showed [9h Ac] and won (109680) with a pair of Aces
Seat 2: SilencedCrow06 folded before Flop (didn't bet)
Seat 3: AlyCWB folded before Flop (didn't bet)
Seat 4: JRSOMBRIO folded before Flop (didn't bet)
Seat 5: JAPA Z/L folded before Flop (didn't bet)
Seat 6: Eneias27 showed [6d As] and lost with a pair of Aces
Seat 7: Legijon folded before Flop (didn't bet)
Seat 8: Mairoula81 (button) folded before Flop (didn't bet)
Seat 9: melmak777 (small blind) folded before Flop



PokerStars Hand #201886470030: Tournament #2634449693, $0.98+$0.12 USD Hold'em No Limit - Level XVII (3000/6000) - 2019/06/30 17:45:37 BRT [2019/06/30 16:45:37 ET]
Table '2634449693 133' 9-max Seat #9 is the button
Seat 1: joaomcneto (109680 in chips) 
Seat 2: SilencedCrow06 (95967 in chips) 
Seat 3: AlyCWB (159802 in chips) 
Seat 4: JRSOMBRIO (83840 in chips) 
Seat 5: JAPA Z/L (425398 in chips) 
Seat 6: Eneias27 (131090 in chips) 
Seat 7: Legijon (297491 in chips) 
Seat 8: Mairoula81 (61636 in chips) 
Seat 9: melmak777 (35540 in chips) 
joaomcneto: posts the ante 600
SilencedCrow06: posts the ante 600
AlyCWB: posts the ante 600
JRSOMBRIO: posts the ante 600
JAPA Z/L: posts the ante 600
Eneias27: posts the ante 600
Legijon: posts the ante 600
Mairoula81: posts the ante 600
melmak777: posts the ante 600
joaomcneto: posts small blind 3000
SilencedCrow06: posts big blind 6000
*** HOLE CARDS ***
Dealt to AlyCWB [Qs Jh]
AlyCWB: folds 
JRSOMBRIO: raises 6000 to 12000
JAPA Z/L: folds 
Eneias27: calls 12000
Legijon: raises 30000 to 42000
Mairoula81: folds 
melmak777: folds 
joaomcneto: folds 
SilencedCrow06: folds 
JRSOMBRIO: folds 
Eneias27: folds 
Uncalled bet (30000) returned to Legijon
Legijon collected 50400 from pot
Legijon: doesn't show hand 
*** SUMMARY ***
Total pot 50400 | Rake 0 
Seat 1: joaomcneto (small blind) folded before Flop
Seat 2: SilencedCrow06 (big blind) folded before Flop
Seat 3: AlyCWB folded before Flop (didn't bet)
Seat 4: JRSOMBRIO folded before Flop
Seat 5: JAPA Z/L folded before Flop (didn't bet)
Seat 6: Eneias27 folded before Flop
Seat 7: Legijon collected (50400)
Seat 8: Mairoula81 folded before Flop (didn't bet)
Seat 9: melmak777 (button) folded before Flop (didn't bet)



PokerStars Hand #201886499719: Tournament #2634449693, $0.98+$0.12 USD Hold'em No Limit - Level XVII (3000/6000) - 2019/06/30 17:46:15 BRT [2019/06/30 16:46:15 ET]
Table '2634449693 133' 9-max Seat #1 is the button
Seat 1: joaomcneto (106080 in chips) 
Seat 2: SilencedCrow06 (89367 in chips) 
Seat 3: AlyCWB (159202 in chips) 
Seat 4: JRSOMBRIO (71240 in chips) 
Seat 5: JAPA Z/L (424798 in chips) 
Seat 6: Eneias27 (118490 in chips) 
Seat 7: Legijon (335291 in chips) 
Seat 8: Mairoula81 (61036 in chips) 
Seat 9: melmak777 (34940 in chips) 
joaomcneto: posts the ante 600
SilencedCrow06: posts the ante 600
AlyCWB: posts the ante 600
JRSOMBRIO: posts the ante 600
JAPA Z/L: posts the ante 600
Eneias27: posts the ante 600
Legijon: posts the ante 600
Mairoula81: posts the ante 600
melmak777: posts the ante 600
SilencedCrow06: posts small blind 3000
AlyCWB: posts big blind 6000
*** HOLE CARDS ***
Dealt to AlyCWB [8c 8d]
JRSOMBRIO: raises 20400 to 26400
JAPA Z/L: folds 
Eneias27: folds 
Legijon: folds 
Mairoula81: folds 
melmak777: folds 
joaomcneto: folds 
SilencedCrow06: folds 
AlyCWB: calls 20400
*** FLOP *** [9s 2h 4s]
AlyCWB: checks 
JRSOMBRIO: bets 24000
AlyCWB: raises 24000 to 48000
JRSOMBRIO: calls 20240 and is all-in
Uncalled bet (3760) returned to AlyCWB
*** TURN *** [9s 2h 4s] [4d]
*** RIVER *** [9s 2h 4s 4d] [3d]
*** SHOW DOWN ***
AlyCWB: shows [8c 8d] (two pair, Eights and Fours)
JRSOMBRIO: shows [As Qh] (a pair of Fours)
AlyCWB collected 149680 from pot
JRSOMBRIO finished the tournament in 1026th place
*** SUMMARY ***
Total pot 149680 | Rake 0 
Board [9s 2h 4s 4d 3d]
Seat 1: joaomcneto (button) folded before Flop (didn't bet)
Seat 2: SilencedCrow06 (small blind) folded before Flop
Seat 3: AlyCWB (big blind) showed [8c 8d] and won (149680) with two pair, Eights and Fours
Seat 4: JRSOMBRIO showed [As Qh] and lost with a pair of Fours
Seat 5: JAPA Z/L folded before Flop (didn't bet)
Seat 6: Eneias27 folded before Flop (didn't bet)
Seat 7: Legijon folded before Flop (didn't bet)
Seat 8: Mairoula81 folded before Flop (didn't bet)
Seat 9: melmak777 folded before Flop (didn't bet)



PokerStars Hand #201886537975: Tournament #2634449693, $0.98+$0.12 USD Hold'em No Limit - Level XVII (3000/6000) - 2019/06/30 17:47:11 BRT [2019/06/30 16:47:11 ET]
Table '2634449693 133' 9-max Seat #2 is the button
Seat 1: joaomcneto (105480 in chips) 
Seat 2: SilencedCrow06 (85767 in chips) 
Seat 3: AlyCWB (237642 in chips) 
Seat 5: JAPA Z/L (424198 in chips) 
Seat 6: Eneias27 (117890 in chips) 
Seat 7: Legijon (334691 in chips) 
Seat 8: Mairoula81 (60436 in chips) 
Seat 9: melmak777 (34340 in chips) 
joaomcneto: posts the ante 600
SilencedCrow06: posts the ante 600
AlyCWB: posts the ante 600
JAPA Z/L: posts the ante 600
Eneias27: posts the ante 600
Legijon: posts the ante 600
Mairoula81: posts the ante 600
melmak777: posts the ante 600
AlyCWB: posts small blind 3000
JAPA Z/L: posts big blind 6000
*** HOLE CARDS ***
Dealt to AlyCWB [2d Kd]
Eneias27: folds 
Legijon: folds 
Mairoula81: raises 53836 to 59836 and is all-in
melmak777: folds 
joaomcneto: folds 
SilencedCrow06: folds 
AlyCWB: folds 
JAPA Z/L: folds 
Uncalled bet (53836) returned to Mairoula81
Mairoula81 collected 19800 from pot
Mairoula81: doesn't show hand 
*** SUMMARY ***
Total pot 19800 | Rake 0 
Seat 1: joaomcneto folded before Flop (didn't bet)
Seat 2: SilencedCrow06 (button) folded before Flop (didn't bet)
Seat 3: AlyCWB (small blind) folded before Flop
Seat 5: JAPA Z/L (big blind) folded before Flop
Seat 6: Eneias27 folded before Flop (didn't bet)
Seat 7: Legijon folded before Flop (didn't bet)
Seat 8: Mairoula81 collected (19800)
Seat 9: melmak777 folded before Flop (didn't bet)



PokerStars Hand #201886558970: Tournament #2634449693, $0.98+$0.12 USD Hold'em No Limit - Level XVII (3000/6000) - 2019/06/30 17:47:42 BRT [2019/06/30 16:47:42 ET]
Table '2634449693 133' 9-max Seat #3 is the button
Seat 1: joaomcneto (104880 in chips) 
Seat 2: SilencedCrow06 (85167 in chips) 
Seat 3: AlyCWB (234042 in chips) 
Seat 4: AndresDL12 (212247 in chips) out of hand (moved from another table into small blind)
Seat 5: JAPA Z/L (417598 in chips) 
Seat 6: Eneias27 (117290 in chips) 
Seat 7: Legijon (334091 in chips) 
Seat 8: Mairoula81 (73636 in chips) 
Seat 9: melmak777 (33740 in chips) 
AndresDL12 will be allowed to play after the button
joaomcneto: posts the ante 600
SilencedCrow06: posts the ante 600
AlyCWB: posts the ante 600
JAPA Z/L: posts the ante 600
Eneias27: posts the ante 600
Legijon: posts the ante 600
Mairoula81: posts the ante 600
melmak777: posts the ante 600
JAPA Z/L: posts small blind 3000
Eneias27: posts big blind 6000
*** HOLE CARDS ***
Dealt to AlyCWB [Jc 2h]
Legijon: folds 
Mairoula81: folds 
melmak777: folds 
joaomcneto: raises 6000 to 12000
SilencedCrow06: folds 
AlyCWB: folds 
JAPA Z/L: folds 
Eneias27: raises 104690 to 116690 and is all-in
joaomcneto: folds 
Uncalled bet (104690) returned to Eneias27
Eneias27 collected 31800 from pot
Eneias27: doesn't show hand 
*** SUMMARY ***
Total pot 31800 | Rake 0 
Seat 1: joaomcneto folded before Flop
Seat 2: SilencedCrow06 folded before Flop (didn't bet)
Seat 3: AlyCWB (button) folded before Flop (didn't bet)
Seat 5: JAPA Z/L (small blind) folded before Flop
Seat 6: Eneias27 (big blind) collected (31800)
Seat 7: Legijon folded before Flop (didn't bet)
Seat 8: Mairoula81 folded before Flop (didn't bet)
Seat 9: melmak777 folded before Flop (didn't bet)



PokerStars Hand #201886582360: Tournament #2634449693, $0.98+$0.12 USD Hold'em No Limit - Level XVIII (3500/7000) - 2019/06/30 17:48:17 BRT [2019/06/30 16:48:17 ET]
Table '2634449693 133' 9-max Seat #5 is the button
Seat 1: joaomcneto (92280 in chips) 
Seat 2: SilencedCrow06 (84567 in chips) 
Seat 3: AlyCWB (233442 in chips) 
Seat 4: AndresDL12 (212247 in chips) 
Seat 5: JAPA Z/L (413998 in chips) 
Seat 6: Eneias27 (136490 in chips) 
Seat 7: Legijon (333491 in chips) 
Seat 8: Mairoula81 (73036 in chips) 
Seat 9: melmak777 (33140 in chips) 
joaomcneto: posts the ante 700
SilencedCrow06: posts the ante 700
AlyCWB: posts the ante 700
AndresDL12: posts the ante 700
JAPA Z/L: posts the ante 700
Eneias27: posts the ante 700
Legijon: posts the ante 700
Mairoula81: posts the ante 700
melmak777: posts the ante 700
Eneias27: posts small blind 3500
Legijon: posts big blind 7000
*** HOLE CARDS ***
Dealt to AlyCWB [Jh Qs]
Mairoula81: folds 
melmak777: folds 
joaomcneto: folds 
SilencedCrow06: folds 
AlyCWB: raises 7000 to 14000
AndresDL12: folds 
JAPA Z/L: folds 
Eneias27: folds 
Legijon: calls 7000
*** FLOP *** [Qd 4s 4c]
Legijon: checks 
AlyCWB: bets 14000
Legijon: calls 14000
*** TURN *** [Qd 4s 4c] [3d]
Legijon: checks 
AlyCWB: checks 
*** RIVER *** [Qd 4s 4c 3d] [Ah]
Legijon: checks 
AlyCWB: checks 
*** SHOW DOWN ***
Legijon: shows [As Td] (two pair, Aces and Fours)
AlyCWB: mucks hand 
Legijon collected 65800 from pot
*** SUMMARY ***
Total pot 65800 | Rake 0 
Board [Qd 4s 4c 3d Ah]
Seat 1: joaomcneto folded before Flop (didn't bet)
Seat 2: SilencedCrow06 folded before Flop (didn't bet)
Seat 3: AlyCWB mucked [Jh Qs]
Seat 4: AndresDL12 folded before Flop (didn't bet)
Seat 5: JAPA Z/L (button) folded before Flop (didn't bet)
Seat 6: Eneias27 (small blind) folded before Flop
Seat 7: Legijon (big blind) showed [As Td] and won (65800) with two pair, Aces and Fours
Seat 8: Mairoula81 folded before Flop (didn't bet)
Seat 9: melmak777 folded before Flop (didn't bet)



PokerStars Hand #201886634732: Tournament #2634449693, $0.98+$0.12 USD Hold'em No Limit - Level XVIII (3500/7000) - 2019/06/30 17:49:34 BRT [2019/06/30 16:49:34 ET]
Table '2634449693 133' 9-max Seat #6 is the button
Seat 1: joaomcneto (91580 in chips) 
Seat 2: SilencedCrow06 (83867 in chips) 
Seat 3: AlyCWB (204742 in chips) 
Seat 4: AndresDL12 (211547 in chips) 
Seat 5: JAPA Z/L (413298 in chips) 
Seat 6: Eneias27 (132290 in chips) 
Seat 7: Legijon (370591 in chips) 
Seat 8: Mairoula81 (72336 in chips) 
Seat 9: melmak777 (32440 in chips) 
joaomcneto: posts the ante 700
SilencedCrow06: posts the ante 700
AlyCWB: posts the ante 700
AndresDL12: posts the ante 700
JAPA Z/L: posts the ante 700
Eneias27: posts the ante 700
Legijon: posts the ante 700
Mairoula81: posts the ante 700
melmak777: posts the ante 700
Legijon: posts small blind 3500
Mairoula81: posts big blind 7000
*** HOLE CARDS ***
Dealt to AlyCWB [Jd 7c]
melmak777: folds 
joaomcneto: folds 
SilencedCrow06: folds 
AlyCWB: folds 
AndresDL12: raises 7000 to 14000
JAPA Z/L: folds 
Eneias27: raises 117590 to 131590 and is all-in
Legijon: folds 
Mairoula81: folds 
AndresDL12: calls 117590
*** FLOP *** [Qc 7h 4c]
*** TURN *** [Qc 7h 4c] [Tc]
*** RIVER *** [Qc 7h 4c Tc] [3d]
*** SHOW DOWN ***
AndresDL12: shows [Ad Td] (a pair of Tens)
Eneias27: shows [Jc Ah] (high card Ace)
AndresDL12 collected 279980 from pot
Eneias27 finished the tournament in 931st place
*** SUMMARY ***
Total pot 279980 | Rake 0 
Board [Qc 7h 4c Tc 3d]
Seat 1: joaomcneto folded before Flop (didn't bet)
Seat 2: SilencedCrow06 folded before Flop (didn't bet)
Seat 3: AlyCWB folded before Flop (didn't bet)
Seat 4: AndresDL12 showed [Ad Td] and won (279980) with a pair of Tens
Seat 5: JAPA Z/L folded before Flop (didn't bet)
Seat 6: Eneias27 (button) showed [Jc Ah] and lost with high card Ace
Seat 7: Legijon (small blind) folded before Flop
Seat 8: Mairoula81 (big blind) folded before Flop
Seat 9: melmak777 folded before Flop (didn't bet)



PokerStars Hand #201886665888: Tournament #2634449693, $0.98+$0.12 USD Hold'em No Limit - Level XVIII (3500/7000) - 2019/06/30 17:50:20 BRT [2019/06/30 16:50:20 ET]
Table '2634449693 133' 9-max Seat #7 is the button
Seat 1: joaomcneto (90880 in chips) 
Seat 2: SilencedCrow06 (83167 in chips) 
Seat 3: AlyCWB (204042 in chips) 
Seat 4: AndresDL12 (359237 in chips) 
Seat 5: JAPA Z/L (412598 in chips) 
Seat 7: Legijon (366391 in chips) 
Seat 8: Mairoula81 (64636 in chips) 
Seat 9: melmak777 (31740 in chips) 
joaomcneto: posts the ante 700
SilencedCrow06: posts the ante 700
AlyCWB: posts the ante 700
AndresDL12: posts the ante 700
JAPA Z/L: posts the ante 700
Legijon: posts the ante 700
Mairoula81: posts the ante 700
melmak777: posts the ante 700
Mairoula81: posts small blind 3500
melmak777: posts big blind 7000
*** HOLE CARDS ***
Dealt to AlyCWB [Jc Tc]
joaomcneto: folds 
SilencedCrow06: folds 
AlyCWB: raises 7000 to 14000
AndresDL12: folds 
JAPA Z/L: folds 
Legijon: folds 
Mairoula81: folds 
melmak777: folds 
Uncalled bet (7000) returned to AlyCWB
AlyCWB collected 23100 from pot
*** SUMMARY ***
Total pot 23100 | Rake 0 
Seat 1: joaomcneto folded before Flop (didn't bet)
Seat 2: SilencedCrow06 folded before Flop (didn't bet)
Seat 3: AlyCWB collected (23100)
Seat 4: AndresDL12 folded before Flop (didn't bet)
Seat 5: JAPA Z/L folded before Flop (didn't bet)
Seat 7: Legijon (button) folded before Flop (didn't bet)
Seat 8: Mairoula81 (small blind) folded before Flop
Seat 9: melmak777 (big blind) folded before Flop



PokerStars Hand #201886700183: Tournament #2634449693, $0.98+$0.12 USD Hold'em No Limit - Level XVIII (3500/7000) - 2019/06/30 17:51:11 BRT [2019/06/30 16:51:11 ET]
Table '2634449693 133' 9-max Seat #8 is the button
Seat 1: joaomcneto (90180 in chips) 
Seat 2: SilencedCrow06 (82467 in chips) 
Seat 3: AlyCWB (219442 in chips) 
Seat 4: AndresDL12 (358537 in chips) 
Seat 5: JAPA Z/L (411898 in chips) 
Seat 6: vantom9598 (371631 in chips) 
Seat 7: Legijon (365691 in chips) 
Seat 8: Mairoula81 (60436 in chips) 
Seat 9: melmak777 (24040 in chips) 
joaomcneto: posts the ante 700
SilencedCrow06: posts the ante 700
AlyCWB: posts the ante 700
AndresDL12: posts the ante 700
JAPA Z/L: posts the ante 700
vantom9598: posts the ante 700
Legijon: posts the ante 700
Mairoula81: posts the ante 700
melmak777: posts the ante 700
melmak777: posts small blind 3500
joaomcneto: posts big blind 7000
*** HOLE CARDS ***
Dealt to AlyCWB [7c Qh]
SilencedCrow06: folds 
AlyCWB: folds 
AndresDL12: folds 
JAPA Z/L: folds 
vantom9598: folds 
Legijon: folds 
Mairoula81: folds 
melmak777: folds 
Uncalled bet (3500) returned to joaomcneto
joaomcneto collected 13300 from pot
joaomcneto: doesn't show hand 
*** SUMMARY ***
Total pot 13300 | Rake 0 
Seat 1: joaomcneto (big blind) collected (13300)
Seat 2: SilencedCrow06 folded before Flop (didn't bet)
Seat 3: AlyCWB folded before Flop (didn't bet)
Seat 4: AndresDL12 folded before Flop (didn't bet)
Seat 5: JAPA Z/L folded before Flop (didn't bet)
Seat 6: vantom9598 folded before Flop (didn't bet)
Seat 7: Legijon folded before Flop (didn't bet)
Seat 8: Mairoula81 (button) folded before Flop (didn't bet)
Seat 9: melmak777 (small blind) folded before Flop



PokerStars Hand #201886724290: Tournament #2634449693, $0.98+$0.12 USD Hold'em No Limit - Level XVIII (3500/7000) - 2019/06/30 17:51:46 BRT [2019/06/30 16:51:46 ET]
Table '2634449693 133' 9-max Seat #9 is the button
Seat 1: joaomcneto (99280 in chips) 
Seat 2: SilencedCrow06 (81767 in chips) 
Seat 3: AlyCWB (218742 in chips) 
Seat 4: AndresDL12 (357837 in chips) 
Seat 5: JAPA Z/L (411198 in chips) 
Seat 6: vantom9598 (370931 in chips) 
Seat 7: Legijon (364991 in chips) 
Seat 8: Mairoula81 (59736 in chips) 
Seat 9: melmak777 (19840 in chips) 
joaomcneto: posts the ante 700
SilencedCrow06: posts the ante 700
AlyCWB: posts the ante 700
AndresDL12: posts the ante 700
JAPA Z/L: posts the ante 700
vantom9598: posts the ante 700
Legijon: posts the ante 700
Mairoula81: posts the ante 700
melmak777: posts the ante 700
joaomcneto: posts small blind 3500
SilencedCrow06: posts big blind 7000
*** HOLE CARDS ***
Dealt to AlyCWB [Jd 5d]
AlyCWB: folds 
AndresDL12: folds 
JAPA Z/L: folds 
vantom9598: folds 
Legijon: folds 
Mairoula81: raises 52036 to 59036 and is all-in
melmak777: folds 
joaomcneto: folds 
SilencedCrow06: folds 
Uncalled bet (52036) returned to Mairoula81
Mairoula81 collected 23800 from pot
Mairoula81: doesn't show hand 
*** SUMMARY ***
Total pot 23800 | Rake 0 
Seat 1: joaomcneto (small blind) folded before Flop
Seat 2: SilencedCrow06 (big blind) folded before Flop
Seat 3: AlyCWB folded before Flop (didn't bet)
Seat 4: AndresDL12 folded before Flop (didn't bet)
Seat 5: JAPA Z/L folded before Flop (didn't bet)
Seat 6: vantom9598 folded before Flop (didn't bet)
Seat 7: Legijon folded before Flop (didn't bet)
Seat 8: Mairoula81 collected (23800)
Seat 9: melmak777 (button) folded before Flop (didn't bet)



PokerStars Hand #201886756211: Tournament #2634449693, $0.98+$0.12 USD Hold'em No Limit - Level XVIII (3500/7000) - 2019/06/30 17:52:34 BRT [2019/06/30 16:52:34 ET]
Table '2634449693 133' 9-max Seat #1 is the button
Seat 1: joaomcneto (95080 in chips) 
Seat 2: SilencedCrow06 (74067 in chips) 
Seat 3: AlyCWB (218042 in chips) 
Seat 4: AndresDL12 (357137 in chips) 
Seat 5: JAPA Z/L (410498 in chips) 
Seat 6: vantom9598 (370231 in chips) 
Seat 7: Legijon (364291 in chips) 
Seat 8: Mairoula81 (75836 in chips) 
Seat 9: melmak777 (19140 in chips) 
joaomcneto: posts the ante 700
SilencedCrow06: posts the ante 700
AlyCWB: posts the ante 700
AndresDL12: posts the ante 700
JAPA Z/L: posts the ante 700
vantom9598: posts the ante 700
Legijon: posts the ante 700
Mairoula81: posts the ante 700
melmak777: posts the ante 700
SilencedCrow06: posts small blind 3500
AlyCWB: posts big blind 7000
*** HOLE CARDS ***
Dealt to AlyCWB [7s 7h]
AndresDL12: folds 
JAPA Z/L: folds 
vantom9598: folds 
Legijon: folds 
Mairoula81: raises 7560 to 14560
melmak777: folds 
joaomcneto: folds 
SilencedCrow06: folds 
AlyCWB: raises 202782 to 217342 and is all-in
Mairoula81: folds [Ad]
Uncalled bet (202782) returned to AlyCWB
AlyCWB collected 38920 from pot
*** SUMMARY ***
Total pot 38920 | Rake 0 
Seat 1: joaomcneto (button) folded before Flop (didn't bet)
Seat 2: SilencedCrow06 (small blind) folded before Flop
Seat 3: AlyCWB (big blind) collected (38920)
Seat 4: AndresDL12 folded before Flop (didn't bet)
Seat 5: JAPA Z/L folded before Flop (didn't bet)
Seat 6: vantom9598 folded before Flop (didn't bet)
Seat 7: Legijon folded before Flop (didn't bet)
Seat 8: Mairoula81 folded before Flop
Seat 9: melmak777 folded before Flop (didn't bet)



PokerStars Hand #201886794211: Tournament #2634449693, $0.98+$0.12 USD Hold'em No Limit - Level XIX (4000/8000) - 2019/06/30 17:53:30 BRT [2019/06/30 16:53:30 ET]
Table '2634449693 133' 9-max Seat #2 is the button
Seat 1: joaomcneto (94380 in chips) 
Seat 2: SilencedCrow06 (69867 in chips) 
Seat 3: AlyCWB (241702 in chips) 
Seat 4: AndresDL12 (356437 in chips) 
Seat 5: JAPA Z/L (409798 in chips) 
Seat 6: vantom9598 (369531 in chips) 
Seat 7: Legijon (363591 in chips) 
Seat 8: Mairoula81 (60576 in chips) 
Seat 9: melmak777 (18440 in chips) 
joaomcneto: posts the ante 800
SilencedCrow06: posts the ante 800
AlyCWB: posts the ante 800
AndresDL12: posts the ante 800
JAPA Z/L: posts the ante 800
vantom9598: posts the ante 800
Legijon: posts the ante 800
Mairoula81: posts the ante 800
melmak777: posts the ante 800
AlyCWB: posts small blind 4000
AndresDL12: posts big blind 8000
*** HOLE CARDS ***
Dealt to AlyCWB [4s 4d]
JAPA Z/L: folds 
vantom9598: raises 8800 to 16800
Legijon: folds 
Mairoula81: folds 
melmak777: folds 
joaomcneto: folds 
SilencedCrow06: folds 
AlyCWB: calls 12800
AndresDL12: calls 8800
*** FLOP *** [9s 2d Th]
AlyCWB: checks 
AndresDL12: bets 16000
vantom9598: calls 16000
AlyCWB: folds 
*** TURN *** [9s 2d Th] [Qs]
AndresDL12: checks 
vantom9598: bets 32000
AndresDL12: folds [9h]
Uncalled bet (32000) returned to vantom9598
vantom9598 collected 89600 from pot
vantom9598: doesn't show hand 
*** SUMMARY ***
Total pot 89600 | Rake 0 
Board [9s 2d Th Qs]
Seat 1: joaomcneto folded before Flop (didn't bet)
Seat 2: SilencedCrow06 (button) folded before Flop (didn't bet)
Seat 3: AlyCWB (small blind) folded on the Flop
Seat 4: AndresDL12 (big blind) folded on the Turn
Seat 5: JAPA Z/L folded before Flop (didn't bet)
Seat 6: vantom9598 collected (89600)
Seat 7: Legijon folded before Flop (didn't bet)
Seat 8: Mairoula81 folded before Flop (didn't bet)
Seat 9: melmak777 folded before Flop (didn't bet)



PokerStars Hand #201886846303: Tournament #2634449693, $0.98+$0.12 USD Hold'em No Limit - Level XIX (4000/8000) - 2019/06/30 17:54:48 BRT [2019/06/30 16:54:48 ET]
Table '2634449693 133' 9-max Seat #3 is the button
Seat 1: joaomcneto (93580 in chips) 
Seat 2: SilencedCrow06 (69067 in chips) 
Seat 3: AlyCWB (224102 in chips) 
Seat 4: AndresDL12 (322837 in chips) 
Seat 5: JAPA Z/L (408998 in chips) 
Seat 6: vantom9598 (425531 in chips) 
Seat 7: Legijon (362791 in chips) 
Seat 8: Mairoula81 (59776 in chips) 
Seat 9: melmak777 (17640 in chips) 
joaomcneto: posts the ante 800
SilencedCrow06: posts the ante 800
AlyCWB: posts the ante 800
AndresDL12: posts the ante 800
JAPA Z/L: posts the ante 800
vantom9598: posts the ante 800
Legijon: posts the ante 800
Mairoula81: posts the ante 800
melmak777: posts the ante 800
AndresDL12: posts small blind 4000
JAPA Z/L: posts big blind 8000
*** HOLE CARDS ***
Dealt to AlyCWB [8d 3h]
vantom9598: folds 
Legijon: folds 
Mairoula81: folds 
melmak777: raises 8840 to 16840 and is all-in
joaomcneto: folds 
SilencedCrow06: raises 51427 to 68267 and is all-in
AlyCWB: folds 
AndresDL12: folds 
JAPA Z/L: folds 
Uncalled bet (51427) returned to SilencedCrow06
*** FLOP *** [7h Ac 4c]
*** TURN *** [7h Ac 4c] [4d]
*** RIVER *** [7h Ac 4c 4d] [6s]
*** SHOW DOWN ***
melmak777: shows [Jd Jh] (two pair, Jacks and Fours)
SilencedCrow06: shows [Qd Qs] (two pair, Queens and Fours)
SilencedCrow06 collected 52880 from pot
melmak777 finished the tournament in 793rd place
*** SUMMARY ***
Total pot 52880 | Rake 0 
Board [7h Ac 4c 4d 6s]
Seat 1: joaomcneto folded before Flop (didn't bet)
Seat 2: SilencedCrow06 showed [Qd Qs] and won (52880) with two pair, Queens and Fours
Seat 3: AlyCWB (button) folded before Flop (didn't bet)
Seat 4: AndresDL12 (small blind) folded before Flop
Seat 5: JAPA Z/L (big blind) folded before Flop
Seat 6: vantom9598 folded before Flop (didn't bet)
Seat 7: Legijon folded before Flop (didn't bet)
Seat 8: Mairoula81 folded before Flop (didn't bet)
Seat 9: melmak777 showed [Jd Jh] and lost with two pair, Jacks and Fours



PokerStars Hand #201887051516: Tournament #2634449693, $0.98+$0.12 USD Hold'em No Limit - Level XIX (4000/8000) - 2019/06/30 18:01:58 BRT [2019/06/30 17:01:58 ET]
Table '2634449693 68' 9-max Seat #2 is the button
Seat 1: PitBulFamily (311556 in chips) 
Seat 2: the_seer1 (307662 in chips) 
Seat 3: MuñozProDR (39900 in chips) is sitting out
Seat 4: xYz ==HP== (242868 in chips) 
Seat 5: mightydane (52230 in chips) 
Seat 6: talgat888 (289522 in chips) 
Seat 7: gabrielscg (378143 in chips) 
Seat 8: swaiz74 (108620 in chips) 
Seat 9: AlyCWB (223302 in chips) 
PitBulFamily: posts the ante 800
the_seer1: posts the ante 800
MuñozProDR: posts the ante 800
xYz ==HP==: posts the ante 800
mightydane: posts the ante 800
talgat888: posts the ante 800
gabrielscg: posts the ante 800
swaiz74: posts the ante 800
AlyCWB: posts the ante 800
MuñozProDR: posts small blind 4000
xYz ==HP==: posts big blind 8000
*** HOLE CARDS ***
Dealt to AlyCWB [3c 6d]
mightydane: folds 
talgat888: folds 
gabrielscg: raises 8000 to 16000
swaiz74: folds 
AlyCWB: folds 
PitBulFamily: calls 16000
the_seer1: folds 
MuñozProDR: folds 
xYz ==HP==: calls 8000
*** FLOP *** [Kh Js Ah]
xYz ==HP==: checks 
gabrielscg: bets 41440
PitBulFamily: folds 
xYz ==HP==: folds 
Uncalled bet (41440) returned to gabrielscg
gabrielscg collected 59200 from pot
*** SUMMARY ***
Total pot 59200 | Rake 0 
Board [Kh Js Ah]
Seat 1: PitBulFamily folded on the Flop
Seat 2: the_seer1 (button) folded before Flop (didn't bet)
Seat 3: MuñozProDR (small blind) folded before Flop
Seat 4: xYz ==HP== (big blind) folded on the Flop
Seat 5: mightydane folded before Flop (didn't bet)
Seat 6: talgat888 folded before Flop (didn't bet)
Seat 7: gabrielscg collected (59200)
Seat 8: swaiz74 folded before Flop (didn't bet)
Seat 9: AlyCWB folded before Flop (didn't bet)



PokerStars Hand #201887117545: Tournament #2634449693, $0.98+$0.12 USD Hold'em No Limit - Level XIX (4000/8000) - 2019/06/30 18:03:38 BRT [2019/06/30 17:03:38 ET]
Table '2634449693 68' 9-max Seat #3 is the button
Seat 1: PitBulFamily (294756 in chips) 
Seat 2: the_seer1 (306862 in chips) 
Seat 3: MuñozProDR (35100 in chips) is sitting out
Seat 4: xYz ==HP== (226068 in chips) 
Seat 5: mightydane (51430 in chips) 
Seat 6: talgat888 (288722 in chips) 
Seat 7: gabrielscg (420543 in chips) 
Seat 8: swaiz74 (107820 in chips) 
Seat 9: AlyCWB (222502 in chips) 
PitBulFamily: posts the ante 800
the_seer1: posts the ante 800
MuñozProDR: posts the ante 800
xYz ==HP==: posts the ante 800
mightydane: posts the ante 800
talgat888: posts the ante 800
gabrielscg: posts the ante 800
swaiz74: posts the ante 800
AlyCWB: posts the ante 800
xYz ==HP==: posts small blind 4000
mightydane: posts big blind 8000
*** HOLE CARDS ***
Dealt to AlyCWB [9s Qc]
talgat888: raises 8000 to 16000
gabrielscg: folds 
swaiz74: calls 16000
AlyCWB: folds 
PitBulFamily: calls 16000
the_seer1: folds 
MuñozProDR: folds 
xYz ==HP==: folds 
mightydane: calls 8000
*** FLOP *** [Kc Ts 5c]
mightydane: checks 
talgat888: bets 37600
swaiz74: folds 
PitBulFamily: calls 37600
mightydane: folds 
*** TURN *** [Kc Ts 5c] [Td]
talgat888: checks 
PitBulFamily: bets 32000
talgat888: folds 
Uncalled bet (32000) returned to PitBulFamily
PitBulFamily collected 150400 from pot
PitBulFamily: doesn't show hand 
*** SUMMARY ***
Total pot 150400 | Rake 0 
Board [Kc Ts 5c Td]
Seat 1: PitBulFamily collected (150400)
Seat 2: the_seer1 folded before Flop (didn't bet)
Seat 3: MuñozProDR (button) folded before Flop (didn't bet)
Seat 4: xYz ==HP== (small blind) folded before Flop
Seat 5: mightydane (big blind) folded on the Flop
Seat 6: talgat888 folded on the Turn
Seat 7: gabrielscg folded before Flop (didn't bet)
Seat 8: swaiz74 folded on the Flop
Seat 9: AlyCWB folded before Flop (didn't bet)



PokerStars Hand #201887178258: Tournament #2634449693, $0.98+$0.12 USD Hold'em No Limit - Level XX (4500/9000) - 2019/06/30 18:05:10 BRT [2019/06/30 17:05:10 ET]
Table '2634449693 68' 9-max Seat #4 is the button
Seat 1: PitBulFamily (390756 in chips) 
Seat 2: the_seer1 (306062 in chips) 
Seat 3: MuñozProDR (34300 in chips) is sitting out
Seat 4: xYz ==HP== (221268 in chips) 
Seat 5: mightydane (34630 in chips) 
Seat 6: talgat888 (234322 in chips) 
Seat 7: gabrielscg (419743 in chips) 
Seat 8: swaiz74 (91020 in chips) 
Seat 9: AlyCWB (221702 in chips) 
PitBulFamily: posts the ante 900
the_seer1: posts the ante 900
MuñozProDR: posts the ante 900
xYz ==HP==: posts the ante 900
mightydane: posts the ante 900
talgat888: posts the ante 900
gabrielscg: posts the ante 900
swaiz74: posts the ante 900
AlyCWB: posts the ante 900
mightydane: posts small blind 4500
talgat888: posts big blind 9000
*** HOLE CARDS ***
Dealt to AlyCWB [9d 3c]
gabrielscg: folds 
swaiz74: folds 
AlyCWB: folds 
PitBulFamily: raises 9000 to 18000
the_seer1: folds 
MuñozProDR: folds 
xYz ==HP==: folds 
mightydane: folds 
talgat888: calls 9000
*** FLOP *** [3d 6c 6h]
talgat888: checks 
PitBulFamily: checks 
*** TURN *** [3d 6c 6h] [Jd]
talgat888: checks 
PitBulFamily: bets 18000
talgat888: calls 18000
*** RIVER *** [3d 6c 6h Jd] [5s]
talgat888: checks 
PitBulFamily: checks 
*** SHOW DOWN ***
talgat888: shows [Ah Tc] (a pair of Sixes)
PitBulFamily: mucks hand 
talgat888 collected 84600 from pot
*** SUMMARY ***
Total pot 84600 | Rake 0 
Board [3d 6c 6h Jd 5s]
Seat 1: PitBulFamily mucked [9h As]
Seat 2: the_seer1 folded before Flop (didn't bet)
Seat 3: MuñozProDR folded before Flop (didn't bet)
Seat 4: xYz ==HP== (button) folded before Flop (didn't bet)
Seat 5: mightydane (small blind) folded before Flop
Seat 6: talgat888 (big blind) showed [Ah Tc] and won (84600) with a pair of Sixes
Seat 7: gabrielscg folded before Flop (didn't bet)
Seat 8: swaiz74 folded before Flop (didn't bet)
Seat 9: AlyCWB folded before Flop (didn't bet)



PokerStars Hand #201887210510: Tournament #2634449693, $0.98+$0.12 USD Hold'em No Limit - Level XX (4500/9000) - 2019/06/30 18:05:57 BRT [2019/06/30 17:05:57 ET]
Table '2634449693 68' 9-max Seat #5 is the button
Seat 1: PitBulFamily (353856 in chips) 
Seat 2: the_seer1 (305162 in chips) 
Seat 3: MuñozProDR (33400 in chips) is sitting out
Seat 4: xYz ==HP== (220368 in chips) 
Seat 5: mightydane (29230 in chips) 
Seat 6: talgat888 (282022 in chips) 
Seat 7: gabrielscg (418843 in chips) 
Seat 8: swaiz74 (90120 in chips) 
Seat 9: AlyCWB (220802 in chips) 
PitBulFamily: posts the ante 900
the_seer1: posts the ante 900
MuñozProDR: posts the ante 900
xYz ==HP==: posts the ante 900
mightydane: posts the ante 900
talgat888: posts the ante 900
gabrielscg: posts the ante 900
swaiz74: posts the ante 900
AlyCWB: posts the ante 900
talgat888: posts small blind 4500
gabrielscg: posts big blind 9000
*** HOLE CARDS ***
Dealt to AlyCWB [Ac As]
swaiz74: folds 
AlyCWB: raises 9000 to 18000
PitBulFamily: folds 
the_seer1: folds 
MuñozProDR: folds 
xYz ==HP==: folds 
mightydane: folds 
talgat888: folds 
gabrielscg: calls 9000
*** FLOP *** [Ah Qh 5d]
gabrielscg: checks 
AlyCWB: checks 
*** TURN *** [Ah Qh 5d] [Kh]
gabrielscg: checks 
AlyCWB: bets 27000
gabrielscg: folds 
Uncalled bet (27000) returned to AlyCWB
AlyCWB collected 48600 from pot
*** SUMMARY ***
Total pot 48600 | Rake 0 
Board [Ah Qh 5d Kh]
Seat 1: PitBulFamily folded before Flop (didn't bet)
Seat 2: the_seer1 folded before Flop (didn't bet)
Seat 3: MuñozProDR folded before Flop (didn't bet)
Seat 4: xYz ==HP== folded before Flop (didn't bet)
Seat 5: mightydane (button) folded before Flop (didn't bet)
Seat 6: talgat888 (small blind) folded before Flop
Seat 7: gabrielscg (big blind) folded on the Turn
Seat 8: swaiz74 folded before Flop (didn't bet)
Seat 9: AlyCWB collected (48600)



PokerStars Hand #201887247192: Tournament #2634449693, $0.98+$0.12 USD Hold'em No Limit - Level XX (4500/9000) - 2019/06/30 18:06:51 BRT [2019/06/30 17:06:51 ET]
Table '2634449693 68' 9-max Seat #6 is the button
Seat 1: PitBulFamily (352956 in chips) 
Seat 2: the_seer1 (304262 in chips) 
Seat 3: MuñozProDR (32500 in chips) is sitting out
Seat 4: xYz ==HP== (219468 in chips) 
Seat 5: mightydane (28330 in chips) 
Seat 6: talgat888 (276622 in chips) 
Seat 7: gabrielscg (399943 in chips) 
Seat 8: swaiz74 (89220 in chips) 
Seat 9: AlyCWB (250502 in chips) 
PitBulFamily: posts the ante 900
the_seer1: posts the ante 900
MuñozProDR: posts the ante 900
xYz ==HP==: posts the ante 900
mightydane: posts the ante 900
talgat888: posts the ante 900
gabrielscg: posts the ante 900
swaiz74: posts the ante 900
AlyCWB: posts the ante 900
gabrielscg: posts small blind 4500
swaiz74: posts big blind 9000
*** HOLE CARDS ***
Dealt to AlyCWB [5h 3c]
AlyCWB: folds 
PitBulFamily: raises 11700 to 20700
the_seer1: folds 
MuñozProDR: folds 
xYz ==HP==: folds 
mightydane: folds 
talgat888: folds 
gabrielscg: folds 
swaiz74 has timed out
swaiz74: folds 
swaiz74 is sitting out
Uncalled bet (11700) returned to PitBulFamily
PitBulFamily collected 30600 from pot
PitBulFamily: doesn't show hand 
*** SUMMARY ***
Total pot 30600 | Rake 0 
Seat 1: PitBulFamily collected (30600)
Seat 2: the_seer1 folded before Flop (didn't bet)
Seat 3: MuñozProDR folded before Flop (didn't bet)
Seat 4: xYz ==HP== folded before Flop (didn't bet)
Seat 5: mightydane folded before Flop (didn't bet)
Seat 6: talgat888 (button) folded before Flop (didn't bet)
Seat 7: gabrielscg (small blind) folded before Flop
Seat 8: swaiz74 (big blind) folded before Flop
Seat 9: AlyCWB folded before Flop (didn't bet)



PokerStars Hand #201887273583: Tournament #2634449693, $0.98+$0.12 USD Hold'em No Limit - Level XX (4500/9000) - 2019/06/30 18:07:30 BRT [2019/06/30 17:07:30 ET]
Table '2634449693 68' 9-max Seat #7 is the button
Seat 1: PitBulFamily (373656 in chips) 
Seat 2: the_seer1 (303362 in chips) 
Seat 3: MuñozProDR (31600 in chips) is sitting out
Seat 4: xYz ==HP== (218568 in chips) 
Seat 5: mightydane (27430 in chips) 
Seat 6: talgat888 (275722 in chips) 
Seat 7: gabrielscg (394543 in chips) 
Seat 8: swaiz74 (79320 in chips) is sitting out
Seat 9: AlyCWB (249602 in chips) 
PitBulFamily: posts the ante 900
the_seer1: posts the ante 900
MuñozProDR: posts the ante 900
xYz ==HP==: posts the ante 900
mightydane: posts the ante 900
talgat888: posts the ante 900
gabrielscg: posts the ante 900
swaiz74: posts the ante 900
AlyCWB: posts the ante 900
swaiz74: posts small blind 4500
AlyCWB: posts big blind 9000
*** HOLE CARDS ***
Dealt to AlyCWB [Ac 5s]
swaiz74 has returned
PitBulFamily: folds 
the_seer1: raises 10433 to 19433
MuñozProDR: folds 
xYz ==HP==: folds 
mightydane: folds 
talgat888: folds 
gabrielscg: folds 
swaiz74: folds 
AlyCWB: calls 10433
*** FLOP *** [2h Qd 3c]
AlyCWB: checks 
the_seer1: checks 
*** TURN *** [2h Qd 3c] [2c]
AlyCWB: checks 
the_seer1: bets 27000
AlyCWB: calls 27000
*** RIVER *** [2h Qd 3c 2c] [4d]
AlyCWB: bets 72000
the_seer1: calls 72000
*** SHOW DOWN ***
AlyCWB: shows [Ac 5s] (a straight, Ace to Five)
the_seer1: mucks hand 
AlyCWB collected 249466 from pot
*** SUMMARY ***
Total pot 249466 | Rake 0 
Board [2h Qd 3c 2c 4d]
Seat 1: PitBulFamily folded before Flop (didn't bet)
Seat 2: the_seer1 mucked [Ad 8d]
Seat 3: MuñozProDR folded before Flop (didn't bet)
Seat 4: xYz ==HP== folded before Flop (didn't bet)
Seat 5: mightydane folded before Flop (didn't bet)
Seat 6: talgat888 folded before Flop (didn't bet)
Seat 7: gabrielscg (button) folded before Flop (didn't bet)
Seat 8: swaiz74 (small blind) folded before Flop
Seat 9: AlyCWB (big blind) showed [Ac 5s] and won (249466) with a straight, Ace to Five



PokerStars Hand #201887329671: Tournament #2634449693, $0.98+$0.12 USD Hold'em No Limit - Level XX (4500/9000) - 2019/06/30 18:08:53 BRT [2019/06/30 17:08:53 ET]
Table '2634449693 68' 9-max Seat #8 is the button
Seat 1: PitBulFamily (372756 in chips) 
Seat 2: the_seer1 (184029 in chips) 
Seat 3: MuñozProDR (30700 in chips) is sitting out
Seat 4: xYz ==HP== (217668 in chips) 
Seat 5: mightydane (26530 in chips) 
Seat 6: talgat888 (274822 in chips) 
Seat 7: gabrielscg (393643 in chips) 
Seat 8: swaiz74 (73920 in chips) 
Seat 9: AlyCWB (379735 in chips) 
PitBulFamily: posts the ante 900
the_seer1: posts the ante 900
MuñozProDR: posts the ante 900
xYz ==HP==: posts the ante 900
mightydane: posts the ante 900
talgat888: posts the ante 900
gabrielscg: posts the ante 900
swaiz74: posts the ante 900
AlyCWB: posts the ante 900
AlyCWB: posts small blind 4500
PitBulFamily: posts big blind 9000
*** HOLE CARDS ***
Dealt to AlyCWB [Td 2s]
the_seer1: folds 
MuñozProDR: folds 
xYz ==HP==: folds 
mightydane: raises 16630 to 25630 and is all-in
talgat888: folds 
gabrielscg: calls 25630
swaiz74: folds 
AlyCWB: folds 
PitBulFamily: folds 
*** FLOP *** [7s 6d 2d]
*** TURN *** [7s 6d 2d] [Ac]
*** RIVER *** [7s 6d 2d Ac] [9c]
*** SHOW DOWN ***
mightydane: shows [4h 4c] (a pair of Fours)
gabrielscg: shows [9h Jh] (a pair of Nines)
gabrielscg collected 72860 from pot
mightydane finished the tournament in 684th place
*** SUMMARY ***
Total pot 72860 | Rake 0 
Board [7s 6d 2d Ac 9c]
Seat 1: PitBulFamily (big blind) folded before Flop
Seat 2: the_seer1 folded before Flop (didn't bet)
Seat 3: MuñozProDR folded before Flop (didn't bet)
Seat 4: xYz ==HP== folded before Flop (didn't bet)
Seat 5: mightydane showed [4h 4c] and lost with a pair of Fours
Seat 6: talgat888 folded before Flop (didn't bet)
Seat 7: gabrielscg showed [9h Jh] and won (72860) with a pair of Nines
Seat 8: swaiz74 (button) folded before Flop (didn't bet)
Seat 9: AlyCWB (small blind) folded before Flop



PokerStars Hand #201887350219: Tournament #2634449693, $0.98+$0.12 USD Hold'em No Limit - Level XX (4500/9000) - 2019/06/30 18:09:24 BRT [2019/06/30 17:09:24 ET]
Table '2634449693 68' 9-max Seat #9 is the button
Seat 1: PitBulFamily (362856 in chips) 
Seat 2: the_seer1 (183129 in chips) 
Seat 3: MuñozProDR (29800 in chips) is sitting out
Seat 4: xYz ==HP== (216768 in chips) 
Seat 6: talgat888 (273922 in chips) 
Seat 7: gabrielscg (439973 in chips) 
Seat 8: swaiz74 (73020 in chips) 
Seat 9: AlyCWB (374335 in chips) 
PitBulFamily: posts the ante 900
the_seer1: posts the ante 900
MuñozProDR: posts the ante 900
xYz ==HP==: posts the ante 900
talgat888: posts the ante 900
gabrielscg: posts the ante 900
swaiz74: posts the ante 900
AlyCWB: posts the ante 900
PitBulFamily: posts small blind 4500
the_seer1: posts big blind 9000
*** HOLE CARDS ***
Dealt to AlyCWB [5h Jd]
MuñozProDR: folds 
MuñozProDR has returned
xYz ==HP==: folds 
talgat888: folds 
gabrielscg: raises 9000 to 18000
swaiz74: folds 
AlyCWB: folds 
PitBulFamily: folds 
the_seer1: calls 9000
*** FLOP *** [3d 9h 9s]
the_seer1: checks 
gabrielscg: bets 16218
the_seer1: raises 16218 to 32436
gabrielscg: calls 16218
*** TURN *** [3d 9h 9s] [6h]
the_seer1: bets 63000
gabrielscg: raises 63000 to 126000
the_seer1: raises 5793 to 131793 and is all-in
gabrielscg: calls 5793
*** RIVER *** [3d 9h 9s 6h] [3c]
*** SHOW DOWN ***
the_seer1: shows [9d 5c] (a full house, Nines full of Threes)
gabrielscg: shows [Qc Qh] (two pair, Queens and Nines)
the_seer1 collected 376158 from pot
*** SUMMARY ***
Total pot 376158 | Rake 0 
Board [3d 9h 9s 6h 3c]
Seat 1: PitBulFamily (small blind) folded before Flop
Seat 2: the_seer1 (big blind) showed [9d 5c] and won (376158) with a full house, Nines full of Threes
Seat 3: MuñozProDR folded before Flop (didn't bet)
Seat 4: xYz ==HP== folded before Flop (didn't bet)
Seat 6: talgat888 folded before Flop (didn't bet)
Seat 7: gabrielscg showed [Qc Qh] and lost with two pair, Queens and Nines
Seat 8: swaiz74 folded before Flop (didn't bet)
Seat 9: AlyCWB (button) folded before Flop (didn't bet)



PokerStars Hand #201887389009: Tournament #2634449693, $0.98+$0.12 USD Hold'em No Limit - Level XXI (5000/10000) - 2019/06/30 18:10:23 BRT [2019/06/30 17:10:23 ET]
Table '2634449693 68' 9-max Seat #1 is the button
Seat 1: PitBulFamily (357456 in chips) 
Seat 2: the_seer1 (376158 in chips) 
Seat 3: MuñozProDR (28900 in chips) 
Seat 4: xYz ==HP== (215868 in chips) 
Seat 5: PAPPPALLLA (193308 in chips) 
Seat 6: talgat888 (273022 in chips) 
Seat 7: gabrielscg (256844 in chips) 
Seat 8: swaiz74 (72120 in chips) 
Seat 9: AlyCWB (373435 in chips) 
PitBulFamily: posts the ante 1000
the_seer1: posts the ante 1000
MuñozProDR: posts the ante 1000
xYz ==HP==: posts the ante 1000
PAPPPALLLA: posts the ante 1000
talgat888: posts the ante 1000
gabrielscg: posts the ante 1000
swaiz74: posts the ante 1000
AlyCWB: posts the ante 1000
the_seer1: posts small blind 5000
MuñozProDR: posts big blind 10000
*** HOLE CARDS ***
Dealt to AlyCWB [Qh Ts]
xYz ==HP==: folds 
PAPPPALLLA: folds 
talgat888: raises 10000 to 20000
gabrielscg: folds 
swaiz74: folds 
AlyCWB: folds 
PitBulFamily: calls 20000
the_seer1: folds 
MuñozProDR: folds 
*** FLOP *** [7c Jd 5c]
talgat888: bets 20000
PitBulFamily: calls 20000
*** TURN *** [7c Jd 5c] [Kc]
talgat888: bets 52000
PitBulFamily: folds 
Uncalled bet (52000) returned to talgat888
talgat888 collected 104000 from pot
*** SUMMARY ***
Total pot 104000 | Rake 0 
Board [7c Jd 5c Kc]
Seat 1: PitBulFamily (button) folded on the Turn
Seat 2: the_seer1 (small blind) folded before Flop
Seat 3: MuñozProDR (big blind) folded before Flop
Seat 4: xYz ==HP== folded before Flop (didn't bet)
Seat 5: PAPPPALLLA folded before Flop (didn't bet)
Seat 6: talgat888 collected (104000)
Seat 7: gabrielscg folded before Flop (didn't bet)
Seat 8: swaiz74 folded before Flop (didn't bet)
Seat 9: AlyCWB folded before Flop (didn't bet)



PokerStars Hand #201887438968: Tournament #2634449693, $0.98+$0.12 USD Hold'em No Limit - Level XXI (5000/10000) - 2019/06/30 18:11:37 BRT [2019/06/30 17:11:37 ET]
Table '2634449693 68' 9-max Seat #2 is the button
Seat 1: PitBulFamily (316456 in chips) 
Seat 2: the_seer1 (370158 in chips) 
Seat 3: MuñozProDR (17900 in chips) 
Seat 4: xYz ==HP== (214868 in chips) 
Seat 5: PAPPPALLLA (192308 in chips) 
Seat 6: talgat888 (336022 in chips) 
Seat 7: gabrielscg (255844 in chips) 
Seat 8: swaiz74 (71120 in chips) 
Seat 9: AlyCWB (372435 in chips) 
PitBulFamily: posts the ante 1000
the_seer1: posts the ante 1000
MuñozProDR: posts the ante 1000
xYz ==HP==: posts the ante 1000
PAPPPALLLA: posts the ante 1000
talgat888: posts the ante 1000
gabrielscg: posts the ante 1000
swaiz74: posts the ante 1000
AlyCWB: posts the ante 1000
MuñozProDR: posts small blind 5000
xYz ==HP==: posts big blind 10000
*** HOLE CARDS ***
Dealt to AlyCWB [4h 9d]
PAPPPALLLA: folds 
talgat888: raises 10000 to 20000
gabrielscg: folds 
swaiz74 has timed out
swaiz74: folds 
swaiz74 is sitting out
AlyCWB: folds 
PitBulFamily: folds 
the_seer1: calls 20000
MuñozProDR: calls 11900 and is all-in
swaiz74 has returned
xYz ==HP==: folds 
*** FLOP *** [Th 9c 2c]
talgat888: checks 
the_seer1: checks 
*** TURN *** [Th 9c 2c] [8s]
talgat888: checks 
the_seer1: checks 
*** RIVER *** [Th 9c 2c 8s] [Qh]
talgat888: checks 
the_seer1: checks 
*** SHOW DOWN ***
talgat888: shows [6h 6c] (a pair of Sixes)
the_seer1: mucks hand 
talgat888 collected 6200 from side pot
MuñozProDR: mucks hand 
talgat888 collected 69700 from main pot
MuñozProDR finished the tournament in 648th place
*** SUMMARY ***
Total pot 75900 Main pot 69700. Side pot 6200. | Rake 0 
Board [Th 9c 2c 8s Qh]
Seat 1: PitBulFamily folded before Flop (didn't bet)
Seat 2: the_seer1 (button) mucked [Ac 5c]
Seat 3: MuñozProDR (small blind) mucked [3c Ad]
Seat 4: xYz ==HP== (big blind) folded before Flop
Seat 5: PAPPPALLLA folded before Flop (didn't bet)
Seat 6: talgat888 showed [6h 6c] and won (75900) with a pair of Sixes
Seat 7: gabrielscg folded before Flop (didn't bet)
Seat 8: swaiz74 folded before Flop (didn't bet)
Seat 9: AlyCWB folded before Flop (didn't bet)



PokerStars Hand #201887473392: Tournament #2634449693, $0.98+$0.12 USD Hold'em No Limit - Level XXI (5000/10000) - 2019/06/30 18:12:28 BRT [2019/06/30 17:12:28 ET]
Table '2634449693 68' 9-max Seat #4 is the button
Seat 1: PitBulFamily (315456 in chips) 
Seat 2: the_seer1 (349158 in chips) 
Seat 4: xYz ==HP== (203868 in chips) 
Seat 5: PAPPPALLLA (191308 in chips) 
Seat 6: talgat888 (390922 in chips) 
Seat 7: gabrielscg (254844 in chips) 
Seat 8: swaiz74 (70120 in chips) 
Seat 9: AlyCWB (371435 in chips) 
PitBulFamily: posts the ante 1000
the_seer1: posts the ante 1000
xYz ==HP==: posts the ante 1000
PAPPPALLLA: posts the ante 1000
talgat888: posts the ante 1000
gabrielscg: posts the ante 1000
swaiz74: posts the ante 1000
AlyCWB: posts the ante 1000
PAPPPALLLA: posts small blind 5000
talgat888: posts big blind 10000
*** HOLE CARDS ***
Dealt to AlyCWB [Kh 5c]
gabrielscg: folds 
swaiz74: folds 
AlyCWB: folds 
PitBulFamily: raises 13000 to 23000
the_seer1: folds 
xYz ==HP==: folds 
PAPPPALLLA: calls 18000
talgat888: calls 13000
*** FLOP *** [4c 4h Ac]
PAPPPALLLA: checks 
talgat888: checks 
PitBulFamily: bets 30030
PAPPPALLLA: calls 30030
talgat888: calls 30030
*** TURN *** [4c 4h Ac] [Qh]
PAPPPALLLA: checks 
talgat888: checks 
PitBulFamily: checks 
*** RIVER *** [4c 4h Ac Qh] [3d]
PAPPPALLLA: checks 
talgat888: checks 
PitBulFamily: checks 
*** SHOW DOWN ***
PAPPPALLLA: shows [Ad Js] (two pair, Aces and Fours)
talgat888: shows [Ah 9h] (two pair, Aces and Fours)
PitBulFamily: mucks hand 
PAPPPALLLA collected 83545 from pot
talgat888 collected 83545 from pot
*** SUMMARY ***
Total pot 167090 | Rake 0 
Board [4c 4h Ac Qh 3d]
Seat 1: PitBulFamily mucked [Tc Kd]
Seat 2: the_seer1 folded before Flop (didn't bet)
Seat 4: xYz ==HP== (button) folded before Flop (didn't bet)
Seat 5: PAPPPALLLA (small blind) showed [Ad Js] and won (83545) with two pair, Aces and Fours
Seat 6: talgat888 (big blind) showed [Ah 9h] and won (83545) with two pair, Aces and Fours
Seat 7: gabrielscg folded before Flop (didn't bet)
Seat 8: swaiz74 folded before Flop (didn't bet)
Seat 9: AlyCWB folded before Flop (didn't bet)



PokerStars Hand #201887509851: Tournament #2634449693, $0.98+$0.12 USD Hold'em No Limit - Level XXI (5000/10000) - 2019/06/30 18:13:23 BRT [2019/06/30 17:13:23 ET]
Table '2634449693 68' 9-max Seat #5 is the button
Seat 1: PitBulFamily (261426 in chips) 
Seat 2: the_seer1 (348158 in chips) 
Seat 3: mbbsorte (255756 in chips) 
Seat 4: xYz ==HP== (202868 in chips) 
Seat 5: PAPPPALLLA (220823 in chips) 
Seat 6: talgat888 (420437 in chips) 
Seat 7: gabrielscg (253844 in chips) 
Seat 8: swaiz74 (69120 in chips) 
Seat 9: AlyCWB (370435 in chips) 
PitBulFamily: posts the ante 1000
the_seer1: posts the ante 1000
mbbsorte: posts the ante 1000
xYz ==HP==: posts the ante 1000
PAPPPALLLA: posts the ante 1000
talgat888: posts the ante 1000
gabrielscg: posts the ante 1000
swaiz74: posts the ante 1000
AlyCWB: posts the ante 1000
talgat888: posts small blind 5000
gabrielscg: posts big blind 10000
*** HOLE CARDS ***
Dealt to AlyCWB [Td Qc]
swaiz74: folds 
AlyCWB: folds 
PitBulFamily: raises 13000 to 23000
the_seer1: folds 
mbbsorte: folds 
xYz ==HP==: folds 
PAPPPALLLA: folds 
talgat888: calls 18000
gabrielscg: folds 
*** FLOP *** [9h Ah 7d]
talgat888: checks 
PitBulFamily: bets 25350
talgat888: calls 25350
*** TURN *** [9h Ah 7d] [6s]
talgat888: checks 
PitBulFamily: bets 45123
talgat888: raises 325964 to 371087 and is all-in
PitBulFamily: folds 
Uncalled bet (325964) returned to talgat888
talgat888 collected 205946 from pot
*** SUMMARY ***
Total pot 205946 | Rake 0 
Board [9h Ah 7d 6s]
Seat 1: PitBulFamily folded on the Turn
Seat 2: the_seer1 folded before Flop (didn't bet)
Seat 3: mbbsorte folded before Flop (didn't bet)
Seat 4: xYz ==HP== folded before Flop (didn't bet)
Seat 5: PAPPPALLLA (button) folded before Flop (didn't bet)
Seat 6: talgat888 (small blind) collected (205946)
Seat 7: gabrielscg (big blind) folded before Flop
Seat 8: swaiz74 folded before Flop (didn't bet)
Seat 9: AlyCWB folded before Flop (didn't bet)



PokerStars Hand #201887681921: Tournament #2634449693, $0.98+$0.12 USD Hold'em No Limit - Level XXII (6000/12000) - 2019/06/30 18:17:32 BRT [2019/06/30 17:17:32 ET]
Table '2634449693 68' 9-max Seat #6 is the button
Seat 1: PitBulFamily (166953 in chips) 
Seat 2: the_seer1 (347158 in chips) 
Seat 3: mbbsorte (254756 in chips) 
Seat 4: xYz ==HP== (201868 in chips) 
Seat 5: PAPPPALLLA (219823 in chips) 
Seat 6: talgat888 (531910 in chips) 
Seat 7: gabrielscg (242844 in chips) 
Seat 8: swaiz74 (68120 in chips) 
Seat 9: AlyCWB (369435 in chips) 
PitBulFamily: posts the ante 1200
the_seer1: posts the ante 1200
mbbsorte: posts the ante 1200
xYz ==HP==: posts the ante 1200
PAPPPALLLA: posts the ante 1200
talgat888: posts the ante 1200
gabrielscg: posts the ante 1200
swaiz74: posts the ante 1200
AlyCWB: posts the ante 1200
gabrielscg: posts small blind 6000
swaiz74: posts big blind 12000
*** HOLE CARDS ***
Dealt to AlyCWB [3s 2s]
AlyCWB: folds 
PitBulFamily: folds 
the_seer1: folds 
mbbsorte: folds 
xYz ==HP==: folds 
PAPPPALLLA: folds 
talgat888: folds 
gabrielscg: raises 229644 to 241644 and is all-in
swaiz74: calls 54920 and is all-in
Uncalled bet (174724) returned to gabrielscg
*** FLOP *** [Kh 5h 4h]
*** TURN *** [Kh 5h 4h] [7h]
*** RIVER *** [Kh 5h 4h 7h] [Jh]
*** SHOW DOWN ***
gabrielscg: shows [6s Ks] (a flush, King high)
swaiz74: shows [6d 2h] (a flush, King high)
gabrielscg collected 72320 from pot
swaiz74 collected 72320 from pot
*** SUMMARY ***
Total pot 144640 | Rake 0 
Board [Kh 5h 4h 7h Jh]
Seat 1: PitBulFamily folded before Flop (didn't bet)
Seat 2: the_seer1 folded before Flop (didn't bet)
Seat 3: mbbsorte folded before Flop (didn't bet)
Seat 4: xYz ==HP== folded before Flop (didn't bet)
Seat 5: PAPPPALLLA folded before Flop (didn't bet)
Seat 6: talgat888 (button) folded before Flop (didn't bet)
Seat 7: gabrielscg (small blind) showed [6s Ks] and won (72320) with a flush, King high
Seat 8: swaiz74 (big blind) showed [6d 2h] and won (72320) with a flush, King high
Seat 9: AlyCWB folded before Flop (didn't bet)



PokerStars Hand #201887715279: Tournament #2634449693, $0.98+$0.12 USD Hold'em No Limit - Level XXII (6000/12000) - 2019/06/30 18:18:22 BRT [2019/06/30 17:18:22 ET]
Table '2634449693 68' 9-max Seat #7 is the button
Seat 1: PitBulFamily (165753 in chips) 
Seat 2: the_seer1 (345958 in chips) 
Seat 3: mbbsorte (253556 in chips) 
Seat 4: xYz ==HP== (200668 in chips) 
Seat 5: PAPPPALLLA (218623 in chips) 
Seat 6: talgat888 (530710 in chips) 
Seat 7: gabrielscg (247044 in chips) 
Seat 8: swaiz74 (72320 in chips) 
Seat 9: AlyCWB (368235 in chips) 
PitBulFamily: posts the ante 1200
the_seer1: posts the ante 1200
mbbsorte: posts the ante 1200
xYz ==HP==: posts the ante 1200
PAPPPALLLA: posts the ante 1200
talgat888: posts the ante 1200
gabrielscg: posts the ante 1200
swaiz74: posts the ante 1200
AlyCWB: posts the ante 1200
swaiz74: posts small blind 6000
AlyCWB: posts big blind 12000
*** HOLE CARDS ***
Dealt to AlyCWB [2h Qh]
PitBulFamily: folds 
the_seer1: folds 
mbbsorte: folds 
xYz ==HP==: folds 
PAPPPALLLA: folds 
talgat888: raises 12000 to 24000
gabrielscg: folds 
swaiz74: folds 
AlyCWB: calls 12000
*** FLOP *** [Ts 8s Jh]
AlyCWB: checks 
talgat888: bets 32400
AlyCWB: calls 32400
*** TURN *** [Ts 8s Jh] [Kh]
AlyCWB: checks 
talgat888: bets 64800
AlyCWB: calls 64800
*** RIVER *** [Ts 8s Jh Kh] [Ac]
AlyCWB: bets 245835 and is all-in
talgat888: folds [Td Tc]
Uncalled bet (245835) returned to AlyCWB
AlyCWB collected 259200 from pot
*** SUMMARY ***
Total pot 259200 | Rake 0 
Board [Ts 8s Jh Kh Ac]
Seat 1: PitBulFamily folded before Flop (didn't bet)
Seat 2: the_seer1 folded before Flop (didn't bet)
Seat 3: mbbsorte folded before Flop (didn't bet)
Seat 4: xYz ==HP== folded before Flop (didn't bet)
Seat 5: PAPPPALLLA folded before Flop (didn't bet)
Seat 6: talgat888 folded on the River
Seat 7: gabrielscg (button) folded before Flop (didn't bet)
Seat 8: swaiz74 (small blind) folded before Flop
Seat 9: AlyCWB (big blind) collected (259200)



PokerStars Hand #201887791649: Tournament #2634449693, $0.98+$0.12 USD Hold'em No Limit - Level XXIII (8000/16000) - 2019/06/30 18:20:16 BRT [2019/06/30 17:20:16 ET]
Table '2634449693 68' 9-max Seat #8 is the button
Seat 1: PitBulFamily (164553 in chips) 
Seat 2: the_seer1 (344758 in chips) 
Seat 3: mbbsorte (252356 in chips) 
Seat 4: xYz ==HP== (199468 in chips) 
Seat 5: PAPPPALLLA (217423 in chips) 
Seat 6: talgat888 (408310 in chips) 
Seat 7: gabrielscg (245844 in chips) 
Seat 8: swaiz74 (65120 in chips) 
Seat 9: AlyCWB (505035 in chips) 
PitBulFamily: posts the ante 1600
the_seer1: posts the ante 1600
mbbsorte: posts the ante 1600
xYz ==HP==: posts the ante 1600
PAPPPALLLA: posts the ante 1600
talgat888: posts the ante 1600
gabrielscg: posts the ante 1600
swaiz74: posts the ante 1600
AlyCWB: posts the ante 1600
AlyCWB: posts small blind 8000
PitBulFamily: posts big blind 16000
*** HOLE CARDS ***
Dealt to AlyCWB [6h 7h]
the_seer1: folds 
mbbsorte: folds 
xYz ==HP==: folds 
PAPPPALLLA: folds 
talgat888: folds 
gabrielscg: folds 
swaiz74 has timed out
swaiz74: folds 
swaiz74 is sitting out
AlyCWB: calls 8000
PitBulFamily: raises 16000 to 32000
AlyCWB: calls 16000
*** FLOP *** [8c 9s 6d]
AlyCWB: checks 
PitBulFamily: bets 30576
AlyCWB: calls 30576
*** TURN *** [8c 9s 6d] [Tc]
AlyCWB: checks 
PitBulFamily: bets 32000
AlyCWB: raises 101776 to 133776
swaiz74 has returned
PitBulFamily: folds 
Uncalled bet (101776) returned to AlyCWB
AlyCWB collected 203552 from pot
*** SUMMARY ***
Total pot 203552 | Rake 0 
Board [8c 9s 6d Tc]
Seat 1: PitBulFamily (big blind) folded on the Turn
Seat 2: the_seer1 folded before Flop (didn't bet)
Seat 3: mbbsorte folded before Flop (didn't bet)
Seat 4: xYz ==HP== folded before Flop (didn't bet)
Seat 5: PAPPPALLLA folded before Flop (didn't bet)
Seat 6: talgat888 folded before Flop (didn't bet)
Seat 7: gabrielscg folded before Flop (didn't bet)
Seat 8: swaiz74 (button) folded before Flop (didn't bet)
Seat 9: AlyCWB (small blind) collected (203552)



PokerStars Hand #201887829304: Tournament #2634449693, $0.98+$0.12 USD Hold'em No Limit - Level XXIII (8000/16000) - 2019/06/30 18:21:12 BRT [2019/06/30 17:21:12 ET]
Table '2634449693 68' 9-max Seat #9 is the button
Seat 1: PitBulFamily (68377 in chips) 
Seat 2: the_seer1 (343158 in chips) 
Seat 3: mbbsorte (250756 in chips) 
Seat 4: xYz ==HP== (197868 in chips) 
Seat 5: PAPPPALLLA (215823 in chips) 
Seat 6: talgat888 (406710 in chips) 
Seat 7: gabrielscg (244244 in chips) 
Seat 8: swaiz74 (63520 in chips) 
Seat 9: AlyCWB (612411 in chips) 
PitBulFamily: posts the ante 1600
the_seer1: posts the ante 1600
mbbsorte: posts the ante 1600
xYz ==HP==: posts the ante 1600
PAPPPALLLA: posts the ante 1600
talgat888: posts the ante 1600
gabrielscg: posts the ante 1600
swaiz74: posts the ante 1600
AlyCWB: posts the ante 1600
PitBulFamily: posts small blind 8000
the_seer1: posts big blind 16000
*** HOLE CARDS ***
Dealt to AlyCWB [6d Kc]
mbbsorte: folds 
xYz ==HP==: folds 
PAPPPALLLA: folds 
talgat888: folds 
gabrielscg: calls 16000
swaiz74: folds 
AlyCWB: folds 
PitBulFamily: folds 
the_seer1: checks 
*** FLOP *** [9d Ts 3d]
the_seer1: checks 
gabrielscg: bets 27200
the_seer1: calls 27200
*** TURN *** [9d Ts 3d] [2s]
the_seer1: checks 
gabrielscg: bets 36992
the_seer1: folds 
Uncalled bet (36992) returned to gabrielscg
gabrielscg collected 108800 from pot
*** SUMMARY ***
Total pot 108800 | Rake 0 
Board [9d Ts 3d 2s]
Seat 1: PitBulFamily (small blind) folded before Flop
Seat 2: the_seer1 (big blind) folded on the Turn
Seat 3: mbbsorte folded before Flop (didn't bet)
Seat 4: xYz ==HP== folded before Flop (didn't bet)
Seat 5: PAPPPALLLA folded before Flop (didn't bet)
Seat 6: talgat888 folded before Flop (didn't bet)
Seat 7: gabrielscg collected (108800)
Seat 8: swaiz74 folded before Flop (didn't bet)
Seat 9: AlyCWB (button) folded before Flop (didn't bet)



PokerStars Hand #201887865414: Tournament #2634449693, $0.98+$0.12 USD Hold'em No Limit - Level XXIII (8000/16000) - 2019/06/30 18:22:06 BRT [2019/06/30 17:22:06 ET]
Table '2634449693 68' 9-max Seat #1 is the button
Seat 1: PitBulFamily (58777 in chips) 
Seat 2: the_seer1 (298358 in chips) 
Seat 3: mbbsorte (249156 in chips) 
Seat 4: xYz ==HP== (196268 in chips) 
Seat 5: PAPPPALLLA (214223 in chips) 
Seat 6: talgat888 (405110 in chips) 
Seat 7: gabrielscg (308244 in chips) 
Seat 8: swaiz74 (61920 in chips) 
Seat 9: AlyCWB (610811 in chips) 
PitBulFamily: posts the ante 1600
the_seer1: posts the ante 1600
mbbsorte: posts the ante 1600
xYz ==HP==: posts the ante 1600
PAPPPALLLA: posts the ante 1600
talgat888: posts the ante 1600
gabrielscg: posts the ante 1600
swaiz74: posts the ante 1600
AlyCWB: posts the ante 1600
the_seer1: posts small blind 8000
mbbsorte: posts big blind 16000
*** HOLE CARDS ***
Dealt to AlyCWB [Qh Th]
xYz ==HP==: folds 
PAPPPALLLA: folds 
talgat888: folds 
gabrielscg: folds 
swaiz74: folds 
AlyCWB: raises 16000 to 32000
PitBulFamily: raises 25177 to 57177 and is all-in
the_seer1: folds 
mbbsorte: raises 190379 to 247556 and is all-in
AlyCWB: folds 
Uncalled bet (190379) returned to mbbsorte
*** FLOP *** [2c Qc 4s]
*** TURN *** [2c Qc 4s] [5h]
*** RIVER *** [2c Qc 4s 5h] [3s]
*** SHOW DOWN ***
mbbsorte: shows [4h 4d] (three of a kind, Fours)
PitBulFamily: shows [Kd 9d] (high card King)
mbbsorte collected 168754 from pot
PitBulFamily finished the tournament in 502nd place and received $1.72.
*** SUMMARY ***
Total pot 168754 | Rake 0 
Board [2c Qc 4s 5h 3s]
Seat 1: PitBulFamily (button) showed [Kd 9d] and lost with high card King
Seat 2: the_seer1 (small blind) folded before Flop
Seat 3: mbbsorte (big blind) showed [4h 4d] and won (168754) with three of a kind, Fours
Seat 4: xYz ==HP== folded before Flop (didn't bet)
Seat 5: PAPPPALLLA folded before Flop (didn't bet)
Seat 6: talgat888 folded before Flop (didn't bet)
Seat 7: gabrielscg folded before Flop (didn't bet)
Seat 8: swaiz74 folded before Flop (didn't bet)
Seat 9: AlyCWB folded before Flop



PokerStars Hand #201887891709: Tournament #2634449693, $0.98+$0.12 USD Hold'em No Limit - Level XXIII (8000/16000) - 2019/06/30 18:22:46 BRT [2019/06/30 17:22:46 ET]
Table '2634449693 68' 9-max Seat #2 is the button
Seat 2: the_seer1 (288758 in chips) 
Seat 3: mbbsorte (359133 in chips) 
Seat 4: xYz ==HP== (194668 in chips) 
Seat 5: PAPPPALLLA (212623 in chips) 
Seat 6: talgat888 (403510 in chips) 
Seat 7: gabrielscg (306644 in chips) 
Seat 8: swaiz74 (60320 in chips) 
Seat 9: AlyCWB (577211 in chips) 
the_seer1: posts the ante 1600
mbbsorte: posts the ante 1600
xYz ==HP==: posts the ante 1600
PAPPPALLLA: posts the ante 1600
talgat888: posts the ante 1600
gabrielscg: posts the ante 1600
swaiz74: posts the ante 1600
AlyCWB: posts the ante 1600
mbbsorte: posts small blind 8000
xYz ==HP==: posts big blind 16000
*** HOLE CARDS ***
Dealt to AlyCWB [2d Jh]
PAPPPALLLA: folds 
talgat888: raises 16000 to 32000
gabrielscg: folds 
swaiz74: folds 
AlyCWB: folds 
the_seer1: folds 
mbbsorte: folds 
xYz ==HP==: calls 16000
*** FLOP *** [4d 6h Qs]
xYz ==HP==: checks 
talgat888: bets 73300
xYz ==HP==: folds 
Uncalled bet (73300) returned to talgat888
talgat888 collected 84800 from pot
*** SUMMARY ***
Total pot 84800 | Rake 0 
Board [4d 6h Qs]
Seat 2: the_seer1 (button) folded before Flop (didn't bet)
Seat 3: mbbsorte (small blind) folded before Flop
Seat 4: xYz ==HP== (big blind) folded on the Flop
Seat 5: PAPPPALLLA folded before Flop (didn't bet)
Seat 6: talgat888 collected (84800)
Seat 7: gabrielscg folded before Flop (didn't bet)
Seat 8: swaiz74 folded before Flop (didn't bet)
Seat 9: AlyCWB folded before Flop (didn't bet)



PokerStars Hand #201887924306: Tournament #2634449693, $0.98+$0.12 USD Hold'em No Limit - Level XXIII (8000/16000) - 2019/06/30 18:23:36 BRT [2019/06/30 17:23:36 ET]
Table '2634449693 68' 9-max Seat #3 is the button
Seat 1: shira_poker (93726 in chips) 
Seat 2: the_seer1 (287158 in chips) 
Seat 3: mbbsorte (349533 in chips) 
Seat 4: xYz ==HP== (161068 in chips) 
Seat 5: PAPPPALLLA (211023 in chips) 
Seat 6: talgat888 (454710 in chips) 
Seat 7: gabrielscg (305044 in chips) 
Seat 8: swaiz74 (58720 in chips) 
Seat 9: AlyCWB (575611 in chips) 
shira_poker: posts the ante 1600
the_seer1: posts the ante 1600
mbbsorte: posts the ante 1600
xYz ==HP==: posts the ante 1600
PAPPPALLLA: posts the ante 1600
talgat888: posts the ante 1600
gabrielscg: posts the ante 1600
swaiz74: posts the ante 1600
AlyCWB: posts the ante 1600
xYz ==HP==: posts small blind 8000
PAPPPALLLA: posts big blind 16000
*** HOLE CARDS ***
Dealt to AlyCWB [3c 6s]
talgat888: folds 
gabrielscg: folds 
swaiz74: folds 
AlyCWB: folds 
shira_poker: folds 
the_seer1: folds 
mbbsorte: raises 331933 to 347933 and is all-in
xYz ==HP==: folds 
PAPPPALLLA: folds 
Uncalled bet (331933) returned to mbbsorte
mbbsorte collected 54400 from pot
*** SUMMARY ***
Total pot 54400 | Rake 0 
Seat 1: shira_poker folded before Flop (didn't bet)
Seat 2: the_seer1 folded before Flop (didn't bet)
Seat 3: mbbsorte (button) collected (54400)
Seat 4: xYz ==HP== (small blind) folded before Flop
Seat 5: PAPPPALLLA (big blind) folded before Flop
Seat 6: talgat888 folded before Flop (didn't bet)
Seat 7: gabrielscg folded before Flop (didn't bet)
Seat 8: swaiz74 folded before Flop (didn't bet)
Seat 9: AlyCWB folded before Flop (didn't bet)



PokerStars Hand #201887942454: Tournament #2634449693, $0.98+$0.12 USD Hold'em No Limit - Level XXIII (8000/16000) - 2019/06/30 18:24:03 BRT [2019/06/30 17:24:03 ET]
Table '2634449693 68' 9-max Seat #4 is the button
Seat 1: shira_poker (92126 in chips) 
Seat 2: the_seer1 (285558 in chips) 
Seat 3: mbbsorte (386333 in chips) 
Seat 4: xYz ==HP== (151468 in chips) 
Seat 5: PAPPPALLLA (193423 in chips) 
Seat 6: talgat888 (453110 in chips) 
Seat 7: gabrielscg (303444 in chips) 
Seat 8: swaiz74 (57120 in chips) 
Seat 9: AlyCWB (574011 in chips) 
shira_poker: posts the ante 1600
the_seer1: posts the ante 1600
mbbsorte: posts the ante 1600
xYz ==HP==: posts the ante 1600
PAPPPALLLA: posts the ante 1600
talgat888: posts the ante 1600
gabrielscg: posts the ante 1600
swaiz74: posts the ante 1600
AlyCWB: posts the ante 1600
PAPPPALLLA: posts small blind 8000
talgat888: posts big blind 16000
*** HOLE CARDS ***
Dealt to AlyCWB [Qd 9h]
gabrielscg: folds 
swaiz74: folds 
AlyCWB: folds 
shira_poker: folds 
the_seer1: folds 
mbbsorte: folds 
xYz ==HP==: raises 133868 to 149868 and is all-in
PAPPPALLLA: folds 
talgat888: calls 133868
*** FLOP *** [Tc 7h 9c]
*** TURN *** [Tc 7h 9c] [Ks]
*** RIVER *** [Tc 7h 9c Ks] [4h]
*** SHOW DOWN ***
talgat888: shows [2h 2d] (a pair of Deuces)
xYz ==HP==: shows [As 7c] (a pair of Sevens)
xYz ==HP== collected 322136 from pot
*** SUMMARY ***
Total pot 322136 | Rake 0 
Board [Tc 7h 9c Ks 4h]
Seat 1: shira_poker folded before Flop (didn't bet)
Seat 2: the_seer1 folded before Flop (didn't bet)
Seat 3: mbbsorte folded before Flop (didn't bet)
Seat 4: xYz ==HP== (button) showed [As 7c] and won (322136) with a pair of Sevens
Seat 5: PAPPPALLLA (small blind) folded before Flop
Seat 6: talgat888 (big blind) showed [2h 2d] and lost with a pair of Deuces
Seat 7: gabrielscg folded before Flop (didn't bet)
Seat 8: swaiz74 folded before Flop (didn't bet)
Seat 9: AlyCWB folded before Flop (didn't bet)



PokerStars Hand #201887976196: Tournament #2634449693, $0.98+$0.12 USD Hold'em No Limit - Level XXIV (10000/20000) - 2019/06/30 18:24:55 BRT [2019/06/30 17:24:55 ET]
Table '2634449693 68' 9-max Seat #5 is the button
Seat 1: shira_poker (90526 in chips) 
Seat 2: the_seer1 (283958 in chips) 
Seat 3: mbbsorte (384733 in chips) 
Seat 4: xYz ==HP== (322136 in chips) 
Seat 5: PAPPPALLLA (183823 in chips) 
Seat 6: talgat888 (301642 in chips) 
Seat 7: gabrielscg (301844 in chips) 
Seat 8: swaiz74 (55520 in chips) 
Seat 9: AlyCWB (572411 in chips) 
shira_poker: posts the ante 2000
the_seer1: posts the ante 2000
mbbsorte: posts the ante 2000
xYz ==HP==: posts the ante 2000
PAPPPALLLA: posts the ante 2000
talgat888: posts the ante 2000
gabrielscg: posts the ante 2000
swaiz74: posts the ante 2000
AlyCWB: posts the ante 2000
talgat888: posts small blind 10000
gabrielscg: posts big blind 20000
*** HOLE CARDS ***
Dealt to AlyCWB [Ks 6s]
swaiz74: folds 
AlyCWB: folds 
shira_poker: folds 
the_seer1: folds 
mbbsorte: raises 23099 to 43099
xYz ==HP==: folds 
PAPPPALLLA: folds 
talgat888: folds 
gabrielscg: calls 23099
*** FLOP *** [3c 5c Qd]
gabrielscg: checks 
mbbsorte: bets 57099
gabrielscg: folds 
Uncalled bet (57099) returned to mbbsorte
mbbsorte collected 114198 from pot
*** SUMMARY ***
Total pot 114198 | Rake 0 
Board [3c 5c Qd]
Seat 1: shira_poker folded before Flop (didn't bet)
Seat 2: the_seer1 folded before Flop (didn't bet)
Seat 3: mbbsorte collected (114198)
Seat 4: xYz ==HP== folded before Flop (didn't bet)
Seat 5: PAPPPALLLA (button) folded before Flop (didn't bet)
Seat 6: talgat888 (small blind) folded before Flop
Seat 7: gabrielscg (big blind) folded on the Flop
Seat 8: swaiz74 folded before Flop (didn't bet)
Seat 9: AlyCWB folded before Flop (didn't bet)



PokerStars Hand #201887998769: Tournament #2634449693, $0.98+$0.12 USD Hold'em No Limit - Level XXIV (10000/20000) - 2019/06/30 18:25:30 BRT [2019/06/30 17:25:30 ET]
Table '2634449693 68' 9-max Seat #6 is the button
Seat 1: shira_poker (88526 in chips) 
Seat 2: the_seer1 (281958 in chips) 
Seat 3: mbbsorte (453832 in chips) 
Seat 4: xYz ==HP== (320136 in chips) 
Seat 5: PAPPPALLLA (181823 in chips) 
Seat 6: talgat888 (289642 in chips) 
Seat 7: gabrielscg (256745 in chips) 
Seat 8: swaiz74 (53520 in chips) 
Seat 9: AlyCWB (570411 in chips) 
shira_poker: posts the ante 2000
the_seer1: posts the ante 2000
mbbsorte: posts the ante 2000
xYz ==HP==: posts the ante 2000
PAPPPALLLA: posts the ante 2000
talgat888: posts the ante 2000
gabrielscg: posts the ante 2000
swaiz74: posts the ante 2000
AlyCWB: posts the ante 2000
gabrielscg: posts small blind 10000
swaiz74: posts big blind 20000
*** HOLE CARDS ***
Dealt to AlyCWB [3c Js]
AlyCWB: folds 
shira_poker: raises 66526 to 86526 and is all-in
the_seer1: folds 
mbbsorte: folds 
xYz ==HP==: folds 
PAPPPALLLA: folds 
talgat888: folds 
gabrielscg: folds 
swaiz74: folds 
Uncalled bet (66526) returned to shira_poker
shira_poker collected 68000 from pot
shira_poker: doesn't show hand 
*** SUMMARY ***
Total pot 68000 | Rake 0 
Seat 1: shira_poker collected (68000)
Seat 2: the_seer1 folded before Flop (didn't bet)
Seat 3: mbbsorte folded before Flop (didn't bet)
Seat 4: xYz ==HP== folded before Flop (didn't bet)
Seat 5: PAPPPALLLA folded before Flop (didn't bet)
Seat 6: talgat888 (button) folded before Flop (didn't bet)
Seat 7: gabrielscg (small blind) folded before Flop
Seat 8: swaiz74 (big blind) folded before Flop
Seat 9: AlyCWB folded before Flop (didn't bet)



PokerStars Hand #201888018654: Tournament #2634449693, $0.98+$0.12 USD Hold'em No Limit - Level XXIV (10000/20000) - 2019/06/30 18:26:00 BRT [2019/06/30 17:26:00 ET]
Table '2634449693 68' 9-max Seat #7 is the button
Seat 1: shira_poker (134526 in chips) 
Seat 2: the_seer1 (279958 in chips) 
Seat 3: mbbsorte (451832 in chips) 
Seat 4: xYz ==HP== (318136 in chips) 
Seat 5: PAPPPALLLA (179823 in chips) 
Seat 6: talgat888 (287642 in chips) 
Seat 7: gabrielscg (244745 in chips) 
Seat 8: swaiz74 (31520 in chips) 
Seat 9: AlyCWB (568411 in chips) 
shira_poker: posts the ante 2000
the_seer1: posts the ante 2000
mbbsorte: posts the ante 2000
xYz ==HP==: posts the ante 2000
PAPPPALLLA: posts the ante 2000
talgat888: posts the ante 2000
gabrielscg: posts the ante 2000
swaiz74: posts the ante 2000
AlyCWB: posts the ante 2000
swaiz74: posts small blind 10000
AlyCWB: posts big blind 20000
*** HOLE CARDS ***
Dealt to AlyCWB [4h Jd]
shira_poker: folds 
the_seer1: folds 
mbbsorte: folds 
xYz ==HP==: folds 
PAPPPALLLA: raises 157823 to 177823 and is all-in
talgat888: folds 
gabrielscg: folds 
swaiz74: folds 
AlyCWB: folds 
Uncalled bet (157823) returned to PAPPPALLLA
PAPPPALLLA collected 68000 from pot
*** SUMMARY ***
Total pot 68000 | Rake 0 
Seat 1: shira_poker folded before Flop (didn't bet)
Seat 2: the_seer1 folded before Flop (didn't bet)
Seat 3: mbbsorte folded before Flop (didn't bet)
Seat 4: xYz ==HP== folded before Flop (didn't bet)
Seat 5: PAPPPALLLA collected (68000)
Seat 6: talgat888 folded before Flop (didn't bet)
Seat 7: gabrielscg (button) folded before Flop (didn't bet)
Seat 8: swaiz74 (small blind) folded before Flop
Seat 9: AlyCWB (big blind) folded before Flop



PokerStars Hand #201888035487: Tournament #2634449693, $0.98+$0.12 USD Hold'em No Limit - Level XXIV (10000/20000) - 2019/06/30 18:26:26 BRT [2019/06/30 17:26:26 ET]
Table '2634449693 68' 9-max Seat #8 is the button
Seat 1: shira_poker (132526 in chips) 
Seat 2: the_seer1 (277958 in chips) 
Seat 3: mbbsorte (449832 in chips) 
Seat 4: xYz ==HP== (316136 in chips) 
Seat 5: PAPPPALLLA (225823 in chips) 
Seat 6: talgat888 (285642 in chips) 
Seat 7: gabrielscg (242745 in chips) 
Seat 8: swaiz74 (19520 in chips) 
Seat 9: AlyCWB (546411 in chips) 
shira_poker: posts the ante 2000
the_seer1: posts the ante 2000
mbbsorte: posts the ante 2000
xYz ==HP==: posts the ante 2000
PAPPPALLLA: posts the ante 2000
talgat888: posts the ante 2000
gabrielscg: posts the ante 2000
swaiz74: posts the ante 2000
AlyCWB: posts the ante 2000
AlyCWB: posts small blind 10000
shira_poker: posts big blind 20000
*** HOLE CARDS ***
Dealt to AlyCWB [Jd 4s]
the_seer1: folds 
mbbsorte: folds 
xYz ==HP==: raises 24000 to 44000
PAPPPALLLA: folds 
talgat888: folds 
gabrielscg: folds 
swaiz74: folds 
AlyCWB: folds 
shira_poker: raises 86526 to 130526 and is all-in
xYz ==HP==: calls 86526
*** FLOP *** [5d Ts 3c]
*** TURN *** [5d Ts 3c] [5h]
*** RIVER *** [5d Ts 3c 5h] [5c]
*** SHOW DOWN ***
shira_poker: shows [Ah 9c] (three of a kind, Fives)
xYz ==HP==: shows [Kh Qd] (three of a kind, Fives - lower kicker)
shira_poker collected 289052 from pot
*** SUMMARY ***
Total pot 289052 | Rake 0 
Board [5d Ts 3c 5h 5c]
Seat 1: shira_poker (big blind) showed [Ah 9c] and won (289052) with three of a kind, Fives
Seat 2: the_seer1 folded before Flop (didn't bet)
Seat 3: mbbsorte folded before Flop (didn't bet)
Seat 4: xYz ==HP== showed [Kh Qd] and lost with three of a kind, Fives
Seat 5: PAPPPALLLA folded before Flop (didn't bet)
Seat 6: talgat888 folded before Flop (didn't bet)
Seat 7: gabrielscg folded before Flop (didn't bet)
Seat 8: swaiz74 (button) folded before Flop (didn't bet)
Seat 9: AlyCWB (small blind) folded before Flop



PokerStars Hand #201888072467: Tournament #2634449693, $0.98+$0.12 USD Hold'em No Limit - Level XXIV (10000/20000) - 2019/06/30 18:27:22 BRT [2019/06/30 17:27:22 ET]
Table '2634449693 68' 9-max Seat #9 is the button
Seat 1: shira_poker (289052 in chips) 
Seat 2: the_seer1 (275958 in chips) 
Seat 3: mbbsorte (447832 in chips) 
Seat 4: xYz ==HP== (183610 in chips) 
Seat 5: PAPPPALLLA (223823 in chips) 
Seat 6: talgat888 (283642 in chips) 
Seat 7: gabrielscg (240745 in chips) 
Seat 8: swaiz74 (17520 in chips) 
Seat 9: AlyCWB (534411 in chips) 
shira_poker: posts the ante 2000
the_seer1: posts the ante 2000
mbbsorte: posts the ante 2000
xYz ==HP==: posts the ante 2000
PAPPPALLLA: posts the ante 2000
talgat888: posts the ante 2000
gabrielscg: posts the ante 2000
swaiz74: posts the ante 2000
AlyCWB: posts the ante 2000
shira_poker: posts small blind 10000
the_seer1: posts big blind 20000
*** HOLE CARDS ***
Dealt to AlyCWB [8h 7s]
mbbsorte: folds 
xYz ==HP==: folds 
PAPPPALLLA: folds 
talgat888: raises 20000 to 40000
gabrielscg: folds 
swaiz74: calls 15520 and is all-in
AlyCWB: folds 
shira_poker: folds 
the_seer1: calls 20000
*** FLOP *** [9h 3h Jc]
the_seer1: checks 
talgat888: checks 
*** TURN *** [9h 3h Jc] [5d]
the_seer1: checks 
talgat888: bets 40000
the_seer1: calls 40000
*** RIVER *** [9h 3h Jc 5d] [2c]
the_seer1: checks 
talgat888: checks 
*** SHOW DOWN ***
the_seer1: shows [5h 6c] (a pair of Fives)
talgat888: shows [5s As] (a pair of Fives - Ace kicker)
talgat888 collected 128960 from side pot
swaiz74: shows [9s Qh] (a pair of Nines)
swaiz74 collected 74560 from main pot
*** SUMMARY ***
Total pot 203520 Main pot 74560. Side pot 128960. | Rake 0 
Board [9h 3h Jc 5d 2c]
Seat 1: shira_poker (small blind) folded before Flop
Seat 2: the_seer1 (big blind) showed [5h 6c] and lost with a pair of Fives
Seat 3: mbbsorte folded before Flop (didn't bet)
Seat 4: xYz ==HP== folded before Flop (didn't bet)
Seat 5: PAPPPALLLA folded before Flop (didn't bet)
Seat 6: talgat888 showed [5s As] and won (128960) with a pair of Fives
Seat 7: gabrielscg folded before Flop (didn't bet)
Seat 8: swaiz74 showed [9s Qh] and won (74560) with a pair of Nines
Seat 9: AlyCWB (button) folded before Flop (didn't bet)



PokerStars Hand #201888110987: Tournament #2634449693, $0.98+$0.12 USD Hold'em No Limit - Level XXIV (10000/20000) - 2019/06/30 18:28:21 BRT [2019/06/30 17:28:21 ET]
Table '2634449693 68' 9-max Seat #1 is the button
Seat 1: shira_poker (277052 in chips) 
Seat 2: the_seer1 (193958 in chips) 
Seat 3: mbbsorte (445832 in chips) 
Seat 4: xYz ==HP== (181610 in chips) 
Seat 5: PAPPPALLLA (221823 in chips) 
Seat 6: talgat888 (330602 in chips) 
Seat 7: gabrielscg (238745 in chips) 
Seat 8: swaiz74 (74560 in chips) 
Seat 9: AlyCWB (532411 in chips) 
shira_poker: posts the ante 2000
the_seer1: posts the ante 2000
mbbsorte: posts the ante 2000
xYz ==HP==: posts the ante 2000
PAPPPALLLA: posts the ante 2000
talgat888: posts the ante 2000
gabrielscg: posts the ante 2000
swaiz74: posts the ante 2000
AlyCWB: posts the ante 2000
the_seer1: posts small blind 10000
mbbsorte: posts big blind 20000
*** HOLE CARDS ***
Dealt to AlyCWB [Ks 6h]
xYz ==HP==: folds 
PAPPPALLLA: folds 
talgat888: folds 
gabrielscg: folds 
swaiz74: calls 20000
AlyCWB: folds 
shira_poker: folds 
the_seer1: calls 10000
mbbsorte: checks 
*** FLOP *** [8d As 5c]
the_seer1: checks 
mbbsorte: bets 60000
swaiz74: calls 52560 and is all-in
the_seer1: raises 111958 to 171958 and is all-in
mbbsorte: folds 
Uncalled bet (111958) returned to the_seer1
*** TURN *** [8d As 5c] [Kc]
*** RIVER *** [8d As 5c Kc] [Kd]
*** SHOW DOWN ***
the_seer1: shows [5d Ad] (two pair, Aces and Kings)
the_seer1 collected 14880 from side pot
swaiz74: shows [6c 8c] (two pair, Kings and Eights)
the_seer1 collected 235680 from main pot
swaiz74 finished the tournament in 385th place and received $2.20.
*** SUMMARY ***
Total pot 250560 Main pot 235680. Side pot 14880. | Rake 0 
Board [8d As 5c Kc Kd]
Seat 1: shira_poker (button) folded before Flop (didn't bet)
Seat 2: the_seer1 (small blind) showed [5d Ad] and won (250560) with two pair, Aces and Kings
Seat 3: mbbsorte (big blind) folded on the Flop
Seat 4: xYz ==HP== folded before Flop (didn't bet)
Seat 5: PAPPPALLLA folded before Flop (didn't bet)
Seat 6: talgat888 folded before Flop (didn't bet)
Seat 7: gabrielscg folded before Flop (didn't bet)
Seat 8: swaiz74 showed [6c 8c] and lost with two pair, Kings and Eights
Seat 9: AlyCWB folded before Flop (didn't bet)



PokerStars Hand #201888146127: Tournament #2634449693, $0.98+$0.12 USD Hold'em No Limit - Level XXIV (10000/20000) - 2019/06/30 18:29:16 BRT [2019/06/30 17:29:16 ET]
Table '2634449693 68' 9-max Seat #2 is the button
Seat 1: shira_poker (275052 in chips) 
Seat 2: the_seer1 (362518 in chips) 
Seat 3: mbbsorte (363832 in chips) 
Seat 4: xYz ==HP== (179610 in chips) 
Seat 5: PAPPPALLLA (219823 in chips) 
Seat 6: talgat888 (328602 in chips) 
Seat 7: gabrielscg (236745 in chips) 
Seat 9: AlyCWB (530411 in chips) 
shira_poker: posts the ante 2000
the_seer1: posts the ante 2000
mbbsorte: posts the ante 2000
xYz ==HP==: posts the ante 2000
PAPPPALLLA: posts the ante 2000
talgat888: posts the ante 2000
gabrielscg: posts the ante 2000
AlyCWB: posts the ante 2000
mbbsorte: posts small blind 10000
xYz ==HP==: posts big blind 20000
*** HOLE CARDS ***
Dealt to AlyCWB [6h Qd]
PAPPPALLLA: folds 
talgat888: raises 20000 to 40000
gabrielscg: folds 
AlyCWB: folds 
shira_poker: folds 
the_seer1: calls 40000
mbbsorte: folds 
xYz ==HP==: calls 20000
*** FLOP *** [Ad 8s 4c]
xYz ==HP==: checks 
talgat888: bets 146000
the_seer1: raises 174518 to 320518 and is all-in
xYz ==HP==: folds 
talgat888: folds 
Uncalled bet (174518) returned to the_seer1
the_seer1 collected 438000 from pot
the_seer1: doesn't show hand 
*** SUMMARY ***
Total pot 438000 | Rake 0 
Board [Ad 8s 4c]
Seat 1: shira_poker folded before Flop (didn't bet)
Seat 2: the_seer1 (button) collected (438000)
Seat 3: mbbsorte (small blind) folded before Flop
Seat 4: xYz ==HP== (big blind) folded on the Flop
Seat 5: PAPPPALLLA folded before Flop (didn't bet)
Seat 6: talgat888 folded on the Flop
Seat 7: gabrielscg folded before Flop (didn't bet)
Seat 9: AlyCWB folded before Flop (didn't bet)



PokerStars Hand #201888183354: Tournament #2634449693, $0.98+$0.12 USD Hold'em No Limit - Level XXV (12500/25000) - 2019/06/30 18:30:13 BRT [2019/06/30 17:30:13 ET]
Table '2634449693 68' 9-max Seat #3 is the button
Seat 1: shira_poker (273052 in chips) 
Seat 2: the_seer1 (612518 in chips) 
Seat 3: mbbsorte (351832 in chips) 
Seat 4: xYz ==HP== (137610 in chips) 
Seat 5: PAPPPALLLA (217823 in chips) 
Seat 6: talgat888 (140602 in chips) 
Seat 7: gabrielscg (234745 in chips) 
Seat 8: vinny323665 (851286 in chips) 
Seat 9: AlyCWB (528411 in chips) 
shira_poker: posts the ante 2500
the_seer1: posts the ante 2500
mbbsorte: posts the ante 2500
xYz ==HP==: posts the ante 2500
PAPPPALLLA: posts the ante 2500
talgat888: posts the ante 2500
gabrielscg: posts the ante 2500
vinny323665: posts the ante 2500
AlyCWB: posts the ante 2500
xYz ==HP==: posts small blind 12500
PAPPPALLLA: posts big blind 25000
*** HOLE CARDS ***
Dealt to AlyCWB [Ac Kh]
talgat888: folds 
gabrielscg: folds 
vinny323665: raises 25000 to 50000
AlyCWB: raises 160000 to 210000
shira_poker: raises 60552 to 270552 and is all-in
the_seer1: folds 
mbbsorte: folds 
xYz ==HP==: folds 
PAPPPALLLA: folds 
vinny323665: folds 
AlyCWB: calls 60552
*** FLOP *** [5d 9h Kc]
*** TURN *** [5d 9h Kc] [6s]
*** RIVER *** [5d 9h Kc 6s] [Tc]
*** SHOW DOWN ***
AlyCWB: shows [Ac Kh] (a pair of Kings)
shira_poker: shows [Ad Kd] (a pair of Kings)
AlyCWB collected 325552 from pot
shira_poker collected 325552 from pot
*** SUMMARY ***
Total pot 651104 | Rake 0 
Board [5d 9h Kc 6s Tc]
Seat 1: shira_poker showed [Ad Kd] and won (325552) with a pair of Kings
Seat 2: the_seer1 folded before Flop (didn't bet)
Seat 3: mbbsorte (button) folded before Flop (didn't bet)
Seat 4: xYz ==HP== (small blind) folded before Flop
Seat 5: PAPPPALLLA (big blind) folded before Flop
Seat 6: talgat888 folded before Flop (didn't bet)
Seat 7: gabrielscg folded before Flop (didn't bet)
Seat 8: vinny323665 folded before Flop
Seat 9: AlyCWB showed [Ac Kh] and won (325552) with a pair of Kings



PokerStars Hand #201888212008: Tournament #2634449693, $0.98+$0.12 USD Hold'em No Limit - Level XXV (12500/25000) - 2019/06/30 18:30:58 BRT [2019/06/30 17:30:58 ET]
Table '2634449693 68' 9-max Seat #4 is the button
Seat 1: shira_poker (325552 in chips) 
Seat 2: the_seer1 (610018 in chips) 
Seat 3: mbbsorte (349332 in chips) 
Seat 4: xYz ==HP== (122610 in chips) 
Seat 5: PAPPPALLLA (190323 in chips) 
Seat 6: talgat888 (138102 in chips) 
Seat 7: gabrielscg (232245 in chips) 
Seat 8: vinny323665 (798786 in chips) 
Seat 9: AlyCWB (580911 in chips) 
shira_poker: posts the ante 2500
the_seer1: posts the ante 2500
mbbsorte: posts the ante 2500
xYz ==HP==: posts the ante 2500
PAPPPALLLA: posts the ante 2500
talgat888: posts the ante 2500
gabrielscg: posts the ante 2500
vinny323665: posts the ante 2500
AlyCWB: posts the ante 2500
PAPPPALLLA: posts small blind 12500
talgat888: posts big blind 25000
*** HOLE CARDS ***
Dealt to AlyCWB [Qd 2h]
gabrielscg: raises 204745 to 229745 and is all-in
vinny323665: folds 
AlyCWB: folds 
shira_poker: folds 
the_seer1: folds 
mbbsorte: folds 
xYz ==HP==: folds 
PAPPPALLLA: folds 
talgat888: calls 110602 and is all-in
Uncalled bet (94143) returned to gabrielscg
*** FLOP *** [6s 5s 7c]
*** TURN *** [6s 5s 7c] [Tc]
*** RIVER *** [6s 5s 7c Tc] [Js]
*** SHOW DOWN ***
talgat888: shows [8d 8s] (a pair of Eights)
gabrielscg: shows [Jh Ac] (a pair of Jacks)
gabrielscg collected 306204 from pot
talgat888 finished the tournament in 358th place and received $2.69.
*** SUMMARY ***
Total pot 306204 | Rake 0 
Board [6s 5s 7c Tc Js]
Seat 1: shira_poker folded before Flop (didn't bet)
Seat 2: the_seer1 folded before Flop (didn't bet)
Seat 3: mbbsorte folded before Flop (didn't bet)
Seat 4: xYz ==HP== (button) folded before Flop (didn't bet)
Seat 5: PAPPPALLLA (small blind) folded before Flop
Seat 6: talgat888 (big blind) showed [8d 8s] and lost with a pair of Eights
Seat 7: gabrielscg showed [Jh Ac] and won (306204) with a pair of Jacks
Seat 8: vinny323665 folded before Flop (didn't bet)
Seat 9: AlyCWB folded before Flop (didn't bet)



PokerStars Hand #201888234987: Tournament #2634449693, $0.98+$0.12 USD Hold'em No Limit - Level XXV (12500/25000) - 2019/06/30 18:31:34 BRT [2019/06/30 17:31:34 ET]
Table '2634449693 68' 9-max Seat #5 is the button
Seat 1: shira_poker (323052 in chips) 
Seat 2: the_seer1 (607518 in chips) 
Seat 3: mbbsorte (346832 in chips) 
Seat 4: xYz ==HP== (120110 in chips) 
Seat 5: PAPPPALLLA (175323 in chips) 
Seat 7: gabrielscg (400347 in chips) 
Seat 8: vinny323665 (796286 in chips) 
Seat 9: AlyCWB (578411 in chips) 
shira_poker: posts the ante 2500
the_seer1: posts the ante 2500
mbbsorte: posts the ante 2500
xYz ==HP==: posts the ante 2500
PAPPPALLLA: posts the ante 2500
gabrielscg: posts the ante 2500
vinny323665: posts the ante 2500
AlyCWB: posts the ante 2500
gabrielscg: posts small blind 12500
vinny323665: posts big blind 25000
*** HOLE CARDS ***
Dealt to AlyCWB [Td 6d]
AlyCWB: folds 
shira_poker: folds 
the_seer1: folds 
mbbsorte: folds 
xYz ==HP==: raises 92610 to 117610 and is all-in
PAPPPALLLA: folds 
gabrielscg: raises 280237 to 397847 and is all-in
vinny323665: folds 
Uncalled bet (280237) returned to gabrielscg
*** FLOP *** [Th 8d 4h]
*** TURN *** [Th 8d 4h] [9s]
*** RIVER *** [Th 8d 4h 9s] [5s]
*** SHOW DOWN ***
gabrielscg: shows [7h 7s] (a pair of Sevens)
xYz ==HP==: shows [8h Ah] (a pair of Eights)
xYz ==HP== collected 280220 from pot
*** SUMMARY ***
Total pot 280220 | Rake 0 
Board [Th 8d 4h 9s 5s]
Seat 1: shira_poker folded before Flop (didn't bet)
Seat 2: the_seer1 folded before Flop (didn't bet)
Seat 3: mbbsorte folded before Flop (didn't bet)
Seat 4: xYz ==HP== showed [8h Ah] and won (280220) with a pair of Eights
Seat 5: PAPPPALLLA (button) folded before Flop (didn't bet)
Seat 7: gabrielscg (small blind) showed [7h 7s] and lost with a pair of Sevens
Seat 8: vinny323665 (big blind) folded before Flop
Seat 9: AlyCWB folded before Flop (didn't bet)



PokerStars Hand #201888260956: Tournament #2634449693, $0.98+$0.12 USD Hold'em No Limit - Level XXV (12500/25000) - 2019/06/30 18:32:14 BRT [2019/06/30 17:32:14 ET]
Table '2634449693 68' 9-max Seat #7 is the button
Seat 1: shira_poker (320552 in chips) 
Seat 2: the_seer1 (605018 in chips) 
Seat 3: mbbsorte (344332 in chips) 
Seat 4: xYz ==HP== (280220 in chips) 
Seat 5: PAPPPALLLA (172823 in chips) 
Seat 6: kblouco (283020 in chips) 
Seat 7: gabrielscg (280237 in chips) 
Seat 8: vinny323665 (768786 in chips) 
Seat 9: AlyCWB (575911 in chips) 
shira_poker: posts the ante 2500
the_seer1: posts the ante 2500
mbbsorte: posts the ante 2500
xYz ==HP==: posts the ante 2500
PAPPPALLLA: posts the ante 2500
kblouco: posts the ante 2500
gabrielscg: posts the ante 2500
vinny323665: posts the ante 2500
AlyCWB: posts the ante 2500
vinny323665: posts small blind 12500
AlyCWB: posts big blind 25000
*** HOLE CARDS ***
Dealt to AlyCWB [3h 6s]
shira_poker: folds 
the_seer1: folds 
mbbsorte: raises 316832 to 341832 and is all-in
xYz ==HP==: folds 
PAPPPALLLA: folds 
kblouco: folds 
gabrielscg: folds 
vinny323665: folds 
AlyCWB: folds 
Uncalled bet (316832) returned to mbbsorte
mbbsorte collected 85000 from pot
*** SUMMARY ***
Total pot 85000 | Rake 0 
Seat 1: shira_poker folded before Flop (didn't bet)
Seat 2: the_seer1 folded before Flop (didn't bet)
Seat 3: mbbsorte collected (85000)
Seat 4: xYz ==HP== folded before Flop (didn't bet)
Seat 5: PAPPPALLLA folded before Flop (didn't bet)
Seat 6: kblouco folded before Flop (didn't bet)
Seat 7: gabrielscg (button) folded before Flop (didn't bet)
Seat 8: vinny323665 (small blind) folded before Flop
Seat 9: AlyCWB (big blind) folded before Flop



PokerStars Hand #201888274769: Tournament #2634449693, $0.98+$0.12 USD Hold'em No Limit - Level XXV (12500/25000) - 2019/06/30 18:32:36 BRT [2019/06/30 17:32:36 ET]
Table '2634449693 68' 9-max Seat #8 is the button
Seat 1: shira_poker (318052 in chips) 
Seat 2: the_seer1 (602518 in chips) 
Seat 3: mbbsorte (401832 in chips) 
Seat 4: xYz ==HP== (277720 in chips) 
Seat 5: PAPPPALLLA (170323 in chips) 
Seat 6: kblouco (280520 in chips) 
Seat 7: gabrielscg (277737 in chips) 
Seat 8: vinny323665 (753786 in chips) 
Seat 9: AlyCWB (548411 in chips) 
shira_poker: posts the ante 2500
the_seer1: posts the ante 2500
mbbsorte: posts the ante 2500
xYz ==HP==: posts the ante 2500
PAPPPALLLA: posts the ante 2500
kblouco: posts the ante 2500
gabrielscg: posts the ante 2500
vinny323665: posts the ante 2500
AlyCWB: posts the ante 2500
AlyCWB: posts small blind 12500
shira_poker: posts big blind 25000
*** HOLE CARDS ***
Dealt to AlyCWB [8c Ad]
the_seer1: folds 
mbbsorte: folds 
xYz ==HP==: raises 250220 to 275220 and is all-in
PAPPPALLLA: folds 
kblouco: folds 
gabrielscg: folds 
vinny323665: folds 
AlyCWB: folds 
shira_poker: folds 
Uncalled bet (250220) returned to xYz ==HP==
xYz ==HP== collected 85000 from pot
xYz ==HP==: doesn't show hand 
*** SUMMARY ***
Total pot 85000 | Rake 0 
Seat 1: shira_poker (big blind) folded before Flop
Seat 2: the_seer1 folded before Flop (didn't bet)
Seat 3: mbbsorte folded before Flop (didn't bet)
Seat 4: xYz ==HP== collected (85000)
Seat 5: PAPPPALLLA folded before Flop (didn't bet)
Seat 6: kblouco folded before Flop (didn't bet)
Seat 7: gabrielscg folded before Flop (didn't bet)
Seat 8: vinny323665 (button) folded before Flop (didn't bet)
Seat 9: AlyCWB (small blind) folded before Flop



PokerStars Hand #201888298467: Tournament #2634449693, $0.98+$0.12 USD Hold'em No Limit - Level XXV (12500/25000) - 2019/06/30 18:33:13 BRT [2019/06/30 17:33:13 ET]
Table '2634449693 68' 9-max Seat #9 is the button
Seat 1: shira_poker (290552 in chips) 
Seat 2: the_seer1 (600018 in chips) 
Seat 3: mbbsorte (399332 in chips) 
Seat 4: xYz ==HP== (335220 in chips) 
Seat 5: PAPPPALLLA (167823 in chips) 
Seat 6: kblouco (278020 in chips) 
Seat 7: gabrielscg (275237 in chips) 
Seat 8: vinny323665 (751286 in chips) 
Seat 9: AlyCWB (533411 in chips) 
shira_poker: posts the ante 2500
the_seer1: posts the ante 2500
mbbsorte: posts the ante 2500
xYz ==HP==: posts the ante 2500
PAPPPALLLA: posts the ante 2500
kblouco: posts the ante 2500
gabrielscg: posts the ante 2500
vinny323665: posts the ante 2500
AlyCWB: posts the ante 2500
shira_poker: posts small blind 12500
the_seer1: posts big blind 25000
*** HOLE CARDS ***
Dealt to AlyCWB [2h 8h]
mbbsorte: folds 
xYz ==HP==: folds 
PAPPPALLLA: folds 
kblouco: folds 
gabrielscg: folds 
vinny323665: raises 25000 to 50000
AlyCWB: folds 
shira_poker: raises 238052 to 288052 and is all-in
the_seer1: folds 
vinny323665: folds 
Uncalled bet (238052) returned to shira_poker
shira_poker collected 147500 from pot
shira_poker: doesn't show hand 
*** SUMMARY ***
Total pot 147500 | Rake 0 
Seat 1: shira_poker (small blind) collected (147500)
Seat 2: the_seer1 (big blind) folded before Flop
Seat 3: mbbsorte folded before Flop (didn't bet)
Seat 4: xYz ==HP== folded before Flop (didn't bet)
Seat 5: PAPPPALLLA folded before Flop (didn't bet)
Seat 6: kblouco folded before Flop (didn't bet)
Seat 7: gabrielscg folded before Flop (didn't bet)
Seat 8: vinny323665 folded before Flop
Seat 9: AlyCWB (button) folded before Flop (didn't bet)



PokerStars Hand #201888320610: Tournament #2634449693, $0.98+$0.12 USD Hold'em No Limit - Level XXV (12500/25000) - 2019/06/30 18:33:48 BRT [2019/06/30 17:33:48 ET]
Table '2634449693 68' 9-max Seat #1 is the button
Seat 1: shira_poker (385552 in chips) 
Seat 2: the_seer1 (572518 in chips) 
Seat 3: mbbsorte (396832 in chips) 
Seat 4: xYz ==HP== (332720 in chips) 
Seat 5: PAPPPALLLA (165323 in chips) 
Seat 6: kblouco (275520 in chips) 
Seat 7: gabrielscg (272737 in chips) 
Seat 8: vinny323665 (698786 in chips) 
Seat 9: AlyCWB (530911 in chips) 
shira_poker: posts the ante 2500
the_seer1: posts the ante 2500
mbbsorte: posts the ante 2500
xYz ==HP==: posts the ante 2500
PAPPPALLLA: posts the ante 2500
kblouco: posts the ante 2500
gabrielscg: posts the ante 2500
vinny323665: posts the ante 2500
AlyCWB: posts the ante 2500
the_seer1: posts small blind 12500
mbbsorte: posts big blind 25000
*** HOLE CARDS ***
Dealt to AlyCWB [9h 6d]
xYz ==HP==: folds 
PAPPPALLLA: folds 
kblouco: folds 
gabrielscg: folds 
vinny323665: folds 
AlyCWB: folds 
shira_poker: raises 358052 to 383052 and is all-in
the_seer1: folds 
mbbsorte: folds 
Uncalled bet (358052) returned to shira_poker
shira_poker collected 85000 from pot
shira_poker: doesn't show hand 
*** SUMMARY ***
Total pot 85000 | Rake 0 
Seat 1: shira_poker (button) collected (85000)
Seat 2: the_seer1 (small blind) folded before Flop
Seat 3: mbbsorte (big blind) folded before Flop
Seat 4: xYz ==HP== folded before Flop (didn't bet)
Seat 5: PAPPPALLLA folded before Flop (didn't bet)
Seat 6: kblouco folded before Flop (didn't bet)
Seat 7: gabrielscg folded before Flop (didn't bet)
Seat 8: vinny323665 folded before Flop (didn't bet)
Seat 9: AlyCWB folded before Flop (didn't bet)



PokerStars Hand #201888344441: Tournament #2634449693, $0.98+$0.12 USD Hold'em No Limit - Level XXV (12500/25000) - 2019/06/30 18:34:25 BRT [2019/06/30 17:34:25 ET]
Table '2634449693 68' 9-max Seat #2 is the button
Seat 1: shira_poker (443052 in chips) 
Seat 2: the_seer1 (557518 in chips) 
Seat 3: mbbsorte (369332 in chips) 
Seat 4: xYz ==HP== (330220 in chips) 
Seat 5: PAPPPALLLA (162823 in chips) 
Seat 6: kblouco (273020 in chips) 
Seat 7: gabrielscg (270237 in chips) 
Seat 8: vinny323665 (696286 in chips) 
Seat 9: AlyCWB (528411 in chips) 
shira_poker: posts the ante 2500
the_seer1: posts the ante 2500
mbbsorte: posts the ante 2500
xYz ==HP==: posts the ante 2500
PAPPPALLLA: posts the ante 2500
kblouco: posts the ante 2500
gabrielscg: posts the ante 2500
vinny323665: posts the ante 2500
AlyCWB: posts the ante 2500
mbbsorte: posts small blind 12500
xYz ==HP==: posts big blind 25000
*** HOLE CARDS ***
Dealt to AlyCWB [Jh Tc]
PAPPPALLLA: folds 
kblouco: folds 
gabrielscg: folds 
vinny323665: folds 
AlyCWB: raises 25000 to 50000
shira_poker: folds 
the_seer1: folds 
mbbsorte: folds 
xYz ==HP==: calls 25000
*** FLOP *** [8s 2h Kc]
xYz ==HP==: checks 
AlyCWB: bets 50000
xYz ==HP==: folds 
Uncalled bet (50000) returned to AlyCWB
AlyCWB collected 135000 from pot
*** SUMMARY ***
Total pot 135000 | Rake 0 
Board [8s 2h Kc]
Seat 1: shira_poker folded before Flop (didn't bet)
Seat 2: the_seer1 (button) folded before Flop (didn't bet)
Seat 3: mbbsorte (small blind) folded before Flop
Seat 4: xYz ==HP== (big blind) folded on the Flop
Seat 5: PAPPPALLLA folded before Flop (didn't bet)
Seat 6: kblouco folded before Flop (didn't bet)
Seat 7: gabrielscg folded before Flop (didn't bet)
Seat 8: vinny323665 folded before Flop (didn't bet)
Seat 9: AlyCWB collected (135000)



PokerStars Hand #201888397891: Tournament #2634449693, $0.98+$0.12 USD Hold'em No Limit - Level XXVI (15000/30000) - 2019/06/30 18:35:49 BRT [2019/06/30 17:35:49 ET]
Table '2634449693 68' 9-max Seat #3 is the button
Seat 1: shira_poker (440552 in chips) 
Seat 2: the_seer1 (555018 in chips) 
Seat 3: mbbsorte (354332 in chips) 
Seat 4: xYz ==HP== (277720 in chips) 
Seat 5: PAPPPALLLA (160323 in chips) 
Seat 6: kblouco (270520 in chips) 
Seat 7: gabrielscg (267737 in chips) 
Seat 8: vinny323665 (693786 in chips) 
Seat 9: AlyCWB (610911 in chips) 
shira_poker: posts the ante 3000
the_seer1: posts the ante 3000
mbbsorte: posts the ante 3000
xYz ==HP==: posts the ante 3000
PAPPPALLLA: posts the ante 3000
kblouco: posts the ante 3000
gabrielscg: posts the ante 3000
vinny323665: posts the ante 3000
AlyCWB: posts the ante 3000
xYz ==HP==: posts small blind 15000
PAPPPALLLA: posts big blind 30000
*** HOLE CARDS ***
Dealt to AlyCWB [Kc 9s]
kblouco: folds 
gabrielscg: folds 
vinny323665: folds 
AlyCWB: folds 
shira_poker: folds 
the_seer1: folds 
mbbsorte: raises 30000 to 60000
xYz ==HP==: folds 
PAPPPALLLA: folds 
Uncalled bet (30000) returned to mbbsorte
mbbsorte collected 102000 from pot
*** SUMMARY ***
Total pot 102000 | Rake 0 
Seat 1: shira_poker folded before Flop (didn't bet)
Seat 2: the_seer1 folded before Flop (didn't bet)
Seat 3: mbbsorte (button) collected (102000)
Seat 4: xYz ==HP== (small blind) folded before Flop
Seat 5: PAPPPALLLA (big blind) folded before Flop
Seat 6: kblouco folded before Flop (didn't bet)
Seat 7: gabrielscg folded before Flop (didn't bet)
Seat 8: vinny323665 folded before Flop (didn't bet)
Seat 9: AlyCWB folded before Flop (didn't bet)



PokerStars Hand #201888440672: Tournament #2634449693, $0.98+$0.12 USD Hold'em No Limit - Level XXVI (15000/30000) - 2019/06/30 18:36:56 BRT [2019/06/30 17:36:56 ET]
Table '2634449693 68' 9-max Seat #4 is the button
Seat 1: shira_poker (437552 in chips) 
Seat 2: the_seer1 (552018 in chips) 
Seat 3: mbbsorte (423332 in chips) 
Seat 4: xYz ==HP== (259720 in chips) 
Seat 5: PAPPPALLLA (127323 in chips) 
Seat 6: kblouco (267520 in chips) 
Seat 7: gabrielscg (264737 in chips) 
Seat 8: vinny323665 (690786 in chips) 
Seat 9: AlyCWB (607911 in chips) 
shira_poker: posts the ante 3000
the_seer1: posts the ante 3000
mbbsorte: posts the ante 3000
xYz ==HP==: posts the ante 3000
PAPPPALLLA: posts the ante 3000
kblouco: posts the ante 3000
gabrielscg: posts the ante 3000
vinny323665: posts the ante 3000
AlyCWB: posts the ante 3000
PAPPPALLLA: posts small blind 15000
kblouco: posts big blind 30000
*** HOLE CARDS ***
Dealt to AlyCWB [6s Tc]
gabrielscg: raises 231735 to 261735
vinny323665: folds 
AlyCWB: folds 
shira_poker: folds 
the_seer1: folds 
mbbsorte: folds 
xYz ==HP==: folds 
PAPPPALLLA: folds 
kblouco: folds 
Uncalled bet (231735) returned to gabrielscg
gabrielscg collected 102000 from pot
*** SUMMARY ***
Total pot 102000 | Rake 0 
Seat 1: shira_poker folded before Flop (didn't bet)
Seat 2: the_seer1 folded before Flop (didn't bet)
Seat 3: mbbsorte folded before Flop (didn't bet)
Seat 4: xYz ==HP== (button) folded before Flop (didn't bet)
Seat 5: PAPPPALLLA (small blind) folded before Flop
Seat 6: kblouco (big blind) folded before Flop
Seat 7: gabrielscg collected (102000)
Seat 8: vinny323665 folded before Flop (didn't bet)
Seat 9: AlyCWB folded before Flop (didn't bet)



PokerStars Hand #201888467561: Tournament #2634449693, $0.98+$0.12 USD Hold'em No Limit - Level XXVI (15000/30000) - 2019/06/30 18:37:39 BRT [2019/06/30 17:37:39 ET]
Table '2634449693 68' 9-max Seat #5 is the button
Seat 1: shira_poker (434552 in chips) 
Seat 2: the_seer1 (549018 in chips) 
Seat 3: mbbsorte (420332 in chips) 
Seat 4: xYz ==HP== (256720 in chips) 
Seat 5: PAPPPALLLA (109323 in chips) 
Seat 6: kblouco (234520 in chips) 
Seat 7: gabrielscg (333737 in chips) 
Seat 8: vinny323665 (687786 in chips) 
Seat 9: AlyCWB (604911 in chips) 
shira_poker: posts the ante 3000
the_seer1: posts the ante 3000
mbbsorte: posts the ante 3000
xYz ==HP==: posts the ante 3000
PAPPPALLLA: posts the ante 3000
kblouco: posts the ante 3000
gabrielscg: posts the ante 3000
vinny323665: posts the ante 3000
AlyCWB: posts the ante 3000
kblouco: posts small blind 15000
gabrielscg: posts big blind 30000
*** HOLE CARDS ***
Dealt to AlyCWB [Qs 5c]
vinny323665: folds 
AlyCWB: folds 
shira_poker: folds 
the_seer1: folds 
mbbsorte: folds 
xYz ==HP==: folds 
PAPPPALLLA: raises 76323 to 106323 and is all-in
kblouco: folds 
gabrielscg: calls 76323
*** FLOP *** [4h 9s 9h]
*** TURN *** [4h 9s 9h] [6h]
*** RIVER *** [4h 9s 9h 6h] [8s]
*** SHOW DOWN ***
gabrielscg: shows [Kc Qd] (a pair of Nines)
PAPPPALLLA: shows [8c Qc] (two pair, Nines and Eights)
PAPPPALLLA collected 254646 from pot
*** SUMMARY ***
Total pot 254646 | Rake 0 
Board [4h 9s 9h 6h 8s]
Seat 1: shira_poker folded before Flop (didn't bet)
Seat 2: the_seer1 folded before Flop (didn't bet)
Seat 3: mbbsorte folded before Flop (didn't bet)
Seat 4: xYz ==HP== folded before Flop (didn't bet)
Seat 5: PAPPPALLLA (button) showed [8c Qc] and won (254646) with two pair, Nines and Eights
Seat 6: kblouco (small blind) folded before Flop
Seat 7: gabrielscg (big blind) showed [Kc Qd] and lost with a pair of Nines
Seat 8: vinny323665 folded before Flop (didn't bet)
Seat 9: AlyCWB folded before Flop (didn't bet)



PokerStars Hand #201888492912: Tournament #2634449693, $0.98+$0.12 USD Hold'em No Limit - Level XXVI (15000/30000) - 2019/06/30 18:38:20 BRT [2019/06/30 17:38:20 ET]
Table '2634449693 68' 9-max Seat #6 is the button
Seat 1: shira_poker (431552 in chips) 
Seat 2: the_seer1 (546018 in chips) 
Seat 3: mbbsorte (417332 in chips) 
Seat 4: xYz ==HP== (253720 in chips) 
Seat 5: PAPPPALLLA (254646 in chips) 
Seat 6: kblouco (216520 in chips) 
Seat 7: gabrielscg (224414 in chips) 
Seat 8: vinny323665 (684786 in chips) 
Seat 9: AlyCWB (601911 in chips) 
shira_poker: posts the ante 3000
the_seer1: posts the ante 3000
mbbsorte: posts the ante 3000
xYz ==HP==: posts the ante 3000
PAPPPALLLA: posts the ante 3000
kblouco: posts the ante 3000
gabrielscg: posts the ante 3000
vinny323665: posts the ante 3000
AlyCWB: posts the ante 3000
gabrielscg: posts small blind 15000
vinny323665: posts big blind 30000
*** HOLE CARDS ***
Dealt to AlyCWB [9c 2d]
AlyCWB: folds 
shira_poker: folds 
the_seer1: folds 
mbbsorte: folds 
xYz ==HP==: folds 
PAPPPALLLA: folds 
kblouco: folds 
gabrielscg: folds 
Uncalled bet (15000) returned to vinny323665
vinny323665 collected 57000 from pot
*** SUMMARY ***
Total pot 57000 | Rake 0 
Seat 1: shira_poker folded before Flop (didn't bet)
Seat 2: the_seer1 folded before Flop (didn't bet)
Seat 3: mbbsorte folded before Flop (didn't bet)
Seat 4: xYz ==HP== folded before Flop (didn't bet)
Seat 5: PAPPPALLLA folded before Flop (didn't bet)
Seat 6: kblouco (button) folded before Flop (didn't bet)
Seat 7: gabrielscg (small blind) folded before Flop
Seat 8: vinny323665 (big blind) collected (57000)
Seat 9: AlyCWB folded before Flop (didn't bet)



PokerStars Hand #201888512944: Tournament #2634449693, $0.98+$0.12 USD Hold'em No Limit - Level XXVI (15000/30000) - 2019/06/30 18:38:52 BRT [2019/06/30 17:38:52 ET]
Table '2634449693 68' 9-max Seat #7 is the button
Seat 1: shira_poker (428552 in chips) 
Seat 2: the_seer1 (543018 in chips) 
Seat 3: mbbsorte (414332 in chips) 
Seat 4: xYz ==HP== (250720 in chips) 
Seat 5: PAPPPALLLA (251646 in chips) 
Seat 6: kblouco (213520 in chips) 
Seat 7: gabrielscg (206414 in chips) 
Seat 8: vinny323665 (723786 in chips) 
Seat 9: AlyCWB (598911 in chips) 
shira_poker: posts the ante 3000
the_seer1: posts the ante 3000
mbbsorte: posts the ante 3000
xYz ==HP==: posts the ante 3000
PAPPPALLLA: posts the ante 3000
kblouco: posts the ante 3000
gabrielscg: posts the ante 3000
vinny323665: posts the ante 3000
AlyCWB: posts the ante 3000
vinny323665: posts small blind 15000
AlyCWB: posts big blind 30000
*** HOLE CARDS ***
Dealt to AlyCWB [Jd 8h]
shira_poker: folds 
the_seer1: folds 
mbbsorte: folds 
xYz ==HP==: folds 
PAPPPALLLA: raises 218646 to 248646 and is all-in
kblouco: folds 
gabrielscg: folds 
vinny323665: folds 
AlyCWB: folds 
Uncalled bet (218646) returned to PAPPPALLLA
PAPPPALLLA collected 102000 from pot
*** SUMMARY ***
Total pot 102000 | Rake 0 
Seat 1: shira_poker folded before Flop (didn't bet)
Seat 2: the_seer1 folded before Flop (didn't bet)
Seat 3: mbbsorte folded before Flop (didn't bet)
Seat 4: xYz ==HP== folded before Flop (didn't bet)
Seat 5: PAPPPALLLA collected (102000)
Seat 6: kblouco folded before Flop (didn't bet)
Seat 7: gabrielscg (button) folded before Flop (didn't bet)
Seat 8: vinny323665 (small blind) folded before Flop
Seat 9: AlyCWB (big blind) folded before Flop



PokerStars Hand #201888534460: Tournament #2634449693, $0.98+$0.12 USD Hold'em No Limit - Level XXVI (15000/30000) - 2019/06/30 18:39:26 BRT [2019/06/30 17:39:26 ET]
Table '2634449693 68' 9-max Seat #8 is the button
Seat 1: shira_poker (425552 in chips) 
Seat 2: the_seer1 (540018 in chips) 
Seat 3: mbbsorte (411332 in chips) 
Seat 4: xYz ==HP== (247720 in chips) 
Seat 5: PAPPPALLLA (320646 in chips) 
Seat 6: kblouco (210520 in chips) 
Seat 7: gabrielscg (203414 in chips) 
Seat 8: vinny323665 (705786 in chips) 
Seat 9: AlyCWB (565911 in chips) 
shira_poker: posts the ante 3000
the_seer1: posts the ante 3000
mbbsorte: posts the ante 3000
xYz ==HP==: posts the ante 3000
PAPPPALLLA: posts the ante 3000
kblouco: posts the ante 3000
gabrielscg: posts the ante 3000
vinny323665: posts the ante 3000
AlyCWB: posts the ante 3000
AlyCWB: posts small blind 15000
shira_poker: posts big blind 30000
*** HOLE CARDS ***
Dealt to AlyCWB [9d Th]
the_seer1: folds 
mbbsorte: folds 
xYz ==HP==: folds 
PAPPPALLLA: folds 
kblouco: folds 
gabrielscg: folds 
vinny323665: raises 30000 to 60000
AlyCWB: folds 
shira_poker: raises 362552 to 422552 and is all-in
vinny323665: folds 
Uncalled bet (362552) returned to shira_poker
shira_poker collected 162000 from pot
shira_poker: doesn't show hand 
*** SUMMARY ***
Total pot 162000 | Rake 0 
Seat 1: shira_poker (big blind) collected (162000)
Seat 2: the_seer1 folded before Flop (didn't bet)
Seat 3: mbbsorte folded before Flop (didn't bet)
Seat 4: xYz ==HP== folded before Flop (didn't bet)
Seat 5: PAPPPALLLA folded before Flop (didn't bet)
Seat 6: kblouco folded before Flop (didn't bet)
Seat 7: gabrielscg folded before Flop (didn't bet)
Seat 8: vinny323665 (button) folded before Flop
Seat 9: AlyCWB (small blind) folded before Flop



PokerStars Hand #201888574491: Tournament #2634449693, $0.98+$0.12 USD Hold'em No Limit - Level XXVII (17500/35000) - 2019/06/30 18:40:30 BRT [2019/06/30 17:40:30 ET]
Table '2634449693 68' 9-max Seat #9 is the button
Seat 1: shira_poker (524552 in chips) 
Seat 2: the_seer1 (537018 in chips) 
Seat 3: mbbsorte (408332 in chips) 
Seat 4: xYz ==HP== (244720 in chips) 
Seat 5: PAPPPALLLA (317646 in chips) 
Seat 6: kblouco (207520 in chips) 
Seat 7: gabrielscg (200414 in chips) 
Seat 8: vinny323665 (642786 in chips) 
Seat 9: AlyCWB (547911 in chips) 
shira_poker: posts the ante 3500
the_seer1: posts the ante 3500
mbbsorte: posts the ante 3500
xYz ==HP==: posts the ante 3500
PAPPPALLLA: posts the ante 3500
kblouco: posts the ante 3500
gabrielscg: posts the ante 3500
vinny323665: posts the ante 3500
AlyCWB: posts the ante 3500
shira_poker: posts small blind 17500
the_seer1: posts big blind 35000
*** HOLE CARDS ***
Dealt to AlyCWB [6c 4h]
mbbsorte: folds 
xYz ==HP==: folds 
PAPPPALLLA: folds 
kblouco: folds 
gabrielscg: raises 161913 to 196913
vinny323665: folds 
AlyCWB: folds 
shira_poker: folds 
the_seer1: calls 161913
*** FLOP *** [Ts Kc 3c]
the_seer1: bets 35000
gabrielscg: calls 1 and is all-in
Uncalled bet (34999) returned to the_seer1
*** TURN *** [Ts Kc 3c] [5h]
*** RIVER *** [Ts Kc 3c 5h] [Tc]
*** SHOW DOWN ***
the_seer1: shows [As 5s] (two pair, Tens and Fives)
gabrielscg: shows [7c Ah] (a pair of Tens)
the_seer1 collected 442828 from pot
gabrielscg finished the tournament in 253rd place and received $3.20.
*** SUMMARY ***
Total pot 442828 | Rake 0 
Board [Ts Kc 3c 5h Tc]
Seat 1: shira_poker (small blind) folded before Flop
Seat 2: the_seer1 (big blind) showed [As 5s] and won (442828) with two pair, Tens and Fives
Seat 3: mbbsorte folded before Flop (didn't bet)
Seat 4: xYz ==HP== folded before Flop (didn't bet)
Seat 5: PAPPPALLLA folded before Flop (didn't bet)
Seat 6: kblouco folded before Flop (didn't bet)
Seat 7: gabrielscg showed [7c Ah] and lost with a pair of Tens
Seat 8: vinny323665 folded before Flop (didn't bet)
Seat 9: AlyCWB (button) folded before Flop (didn't bet)



PokerStars Hand #201888615258: Tournament #2634449693, $0.98+$0.12 USD Hold'em No Limit - Level XXVII (17500/35000) - 2019/06/30 18:41:36 BRT [2019/06/30 17:41:36 ET]
Table '2634449693 136' 9-max Seat #2 is the button
Seat 2: llucaschaves (407594 in chips) 
Seat 3: modraa (1519121 in chips) 
Seat 4: pvjach (265680 in chips) 
Seat 5: tasty25 (455412 in chips) 
Seat 6: tatastar70 (456090 in chips) 
Seat 7: SenQQu (88394 in chips) 
Seat 8: AlyCWB (544411 in chips) 
Seat 9: DRONIQQ (165392 in chips) 
llucaschaves: posts the ante 3500
modraa: posts the ante 3500
pvjach: posts the ante 3500
tasty25: posts the ante 3500
tatastar70: posts the ante 3500
SenQQu: posts the ante 3500
AlyCWB: posts the ante 3500
DRONIQQ: posts the ante 3500
modraa: posts small blind 17500
pvjach: posts big blind 35000
*** HOLE CARDS ***
Dealt to AlyCWB [3d 3h]
tasty25: calls 35000
tatastar70: folds 
SenQQu: folds 
AlyCWB: calls 35000
DRONIQQ: folds 
llucaschaves: folds 
modraa: calls 17500
pvjach: checks 
*** FLOP *** [As 8s Th]
modraa: checks 
pvjach: checks 
tasty25: checks 
AlyCWB: bets 70000
modraa: folds 
pvjach: folds 
tasty25: folds 
Uncalled bet (70000) returned to AlyCWB
AlyCWB collected 168000 from pot
*** SUMMARY ***
Total pot 168000 | Rake 0 
Board [As 8s Th]
Seat 2: llucaschaves (button) folded before Flop (didn't bet)
Seat 3: modraa (small blind) folded on the Flop
Seat 4: pvjach (big blind) folded on the Flop
Seat 5: tasty25 folded on the Flop
Seat 6: tatastar70 folded before Flop (didn't bet)
Seat 7: SenQQu folded before Flop (didn't bet)
Seat 8: AlyCWB collected (168000)
Seat 9: DRONIQQ folded before Flop (didn't bet)



PokerStars Hand #201888634205: Tournament #2634449693, $0.98+$0.12 USD Hold'em No Limit - Level XXVII (17500/35000) - 2019/06/30 18:42:07 BRT [2019/06/30 17:42:07 ET]
Table '2634449693 136' 9-max Seat #3 is the button
Seat 1: manoel2007 (504012 in chips) 
Seat 2: llucaschaves (404094 in chips) 
Seat 3: modraa (1480621 in chips) 
Seat 4: pvjach (227180 in chips) 
Seat 5: tasty25 (416912 in chips) 
Seat 6: tatastar70 (452590 in chips) 
Seat 7: SenQQu (84894 in chips) 
Seat 8: AlyCWB (673911 in chips) 
Seat 9: DRONIQQ (161892 in chips) 
manoel2007: posts the ante 3500
llucaschaves: posts the ante 3500
modraa: posts the ante 3500
pvjach: posts the ante 3500
tasty25: posts the ante 3500
tatastar70: posts the ante 3500
SenQQu: posts the ante 3500
AlyCWB: posts the ante 3500
DRONIQQ: posts the ante 3500
pvjach: posts small blind 17500
tasty25: posts big blind 35000
*** HOLE CARDS ***
Dealt to AlyCWB [Th 5d]
tatastar70: folds 
SenQQu: raises 46394 to 81394 and is all-in
AlyCWB: folds 
DRONIQQ: folds 
manoel2007: folds 
llucaschaves: folds 
modraa: raises 1395727 to 1477121 and is all-in
pvjach: folds 
tasty25: folds 
Uncalled bet (1395727) returned to modraa
*** FLOP *** [Kh 9d Ad]
*** TURN *** [Kh 9d Ad] [Kd]
*** RIVER *** [Kh 9d Ad Kd] [Td]
*** SHOW DOWN ***
SenQQu: shows [7d 7c] (a flush, Ace high)
modraa: shows [Jh Ah] (two pair, Aces and Kings)
SenQQu collected 246788 from pot
*** SUMMARY ***
Total pot 246788 | Rake 0 
Board [Kh 9d Ad Kd Td]
Seat 1: manoel2007 folded before Flop (didn't bet)
Seat 2: llucaschaves folded before Flop (didn't bet)
Seat 3: modraa (button) showed [Jh Ah] and lost with two pair, Aces and Kings
Seat 4: pvjach (small blind) folded before Flop
Seat 5: tasty25 (big blind) folded before Flop
Seat 6: tatastar70 folded before Flop (didn't bet)
Seat 7: SenQQu showed [7d 7c] and won (246788) with a flush, Ace high
Seat 8: AlyCWB folded before Flop (didn't bet)
Seat 9: DRONIQQ folded before Flop (didn't bet)



PokerStars Hand #201888655026: Tournament #2634449693, $0.98+$0.12 USD Hold'em No Limit - Level XXVII (17500/35000) - 2019/06/30 18:42:41 BRT [2019/06/30 17:42:41 ET]
Table '2634449693 136' 9-max Seat #4 is the button
Seat 1: manoel2007 (500512 in chips) 
Seat 2: llucaschaves (400594 in chips) 
Seat 3: modraa (1395727 in chips) 
Seat 4: pvjach (206180 in chips) 
Seat 5: tasty25 (378412 in chips) 
Seat 6: tatastar70 (449090 in chips) 
Seat 7: SenQQu (246788 in chips) 
Seat 8: AlyCWB (670411 in chips) 
Seat 9: DRONIQQ (158392 in chips) 
manoel2007: posts the ante 3500
llucaschaves: posts the ante 3500
modraa: posts the ante 3500
pvjach: posts the ante 3500
tasty25: posts the ante 3500
tatastar70: posts the ante 3500
SenQQu: posts the ante 3500
AlyCWB: posts the ante 3500
DRONIQQ: posts the ante 3500
tasty25: posts small blind 17500
tatastar70: posts big blind 35000
*** HOLE CARDS ***
Dealt to AlyCWB [2s 4s]
SenQQu: folds 
AlyCWB: folds 
DRONIQQ: folds 
manoel2007: folds 
llucaschaves: raises 362094 to 397094 and is all-in
modraa: folds 
pvjach: folds 
tasty25: folds 
tatastar70: folds 
Uncalled bet (362094) returned to llucaschaves
llucaschaves collected 119000 from pot
*** SUMMARY ***
Total pot 119000 | Rake 0 
Seat 1: manoel2007 folded before Flop (didn't bet)
Seat 2: llucaschaves collected (119000)
Seat 3: modraa folded before Flop (didn't bet)
Seat 4: pvjach (button) folded before Flop (didn't bet)
Seat 5: tasty25 (small blind) folded before Flop
Seat 6: tatastar70 (big blind) folded before Flop
Seat 7: SenQQu folded before Flop (didn't bet)
Seat 8: AlyCWB folded before Flop (didn't bet)
Seat 9: DRONIQQ folded before Flop (didn't bet)



PokerStars Hand #201888674900: Tournament #2634449693, $0.98+$0.12 USD Hold'em No Limit - Level XXVII (17500/35000) - 2019/06/30 18:43:13 BRT [2019/06/30 17:43:13 ET]
Table '2634449693 136' 9-max Seat #5 is the button
Seat 1: manoel2007 (497012 in chips) 
Seat 2: llucaschaves (481094 in chips) 
Seat 3: modraa (1392227 in chips) 
Seat 4: pvjach (202680 in chips) 
Seat 5: tasty25 (357412 in chips) 
Seat 6: tatastar70 (410590 in chips) 
Seat 7: SenQQu (243288 in chips) 
Seat 8: AlyCWB (666911 in chips) 
Seat 9: DRONIQQ (154892 in chips) 
manoel2007: posts the ante 3500
llucaschaves: posts the ante 3500
modraa: posts the ante 3500
pvjach: posts the ante 3500
tasty25: posts the ante 3500
tatastar70: posts the ante 3500
SenQQu: posts the ante 3500
AlyCWB: posts the ante 3500
DRONIQQ: posts the ante 3500
tatastar70: posts small blind 17500
SenQQu: posts big blind 35000
*** HOLE CARDS ***
Dealt to AlyCWB [Tc 5c]
AlyCWB: folds 
DRONIQQ: raises 116392 to 151392 and is all-in
manoel2007: folds 
llucaschaves: folds 
modraa: folds 
pvjach: folds 
tasty25: folds 
tatastar70: folds 
SenQQu: folds 
Uncalled bet (116392) returned to DRONIQQ
DRONIQQ collected 119000 from pot
DRONIQQ: doesn't show hand 
*** SUMMARY ***
Total pot 119000 | Rake 0 
Seat 1: manoel2007 folded before Flop (didn't bet)
Seat 2: llucaschaves folded before Flop (didn't bet)
Seat 3: modraa folded before Flop (didn't bet)
Seat 4: pvjach folded before Flop (didn't bet)
Seat 5: tasty25 (button) folded before Flop (didn't bet)
Seat 6: tatastar70 (small blind) folded before Flop
Seat 7: SenQQu (big blind) folded before Flop
Seat 8: AlyCWB folded before Flop (didn't bet)
Seat 9: DRONIQQ collected (119000)



PokerStars Hand #201888697355: Tournament #2634449693, $0.98+$0.12 USD Hold'em No Limit - Level XXVII (17500/35000) - 2019/06/30 18:43:49 BRT [2019/06/30 17:43:49 ET]
Table '2634449693 136' 9-max Seat #6 is the button
Seat 1: manoel2007 (493512 in chips) 
Seat 2: llucaschaves (477594 in chips) 
Seat 3: modraa (1388727 in chips) 
Seat 4: pvjach (199180 in chips) 
Seat 5: tasty25 (353912 in chips) 
Seat 6: tatastar70 (389590 in chips) 
Seat 7: SenQQu (204788 in chips) 
Seat 8: AlyCWB (663411 in chips) 
Seat 9: DRONIQQ (235392 in chips) 
manoel2007: posts the ante 3500
llucaschaves: posts the ante 3500
modraa: posts the ante 3500
pvjach: posts the ante 3500
tasty25: posts the ante 3500
tatastar70: posts the ante 3500
SenQQu: posts the ante 3500
AlyCWB: posts the ante 3500
DRONIQQ: posts the ante 3500
SenQQu: posts small blind 17500
AlyCWB: posts big blind 35000
*** HOLE CARDS ***
Dealt to AlyCWB [9s 2s]
DRONIQQ: folds 
manoel2007: folds 
llucaschaves: folds 
modraa: raises 35000 to 70000
pvjach: raises 125680 to 195680 and is all-in
tasty25: raises 154732 to 350412 and is all-in
tatastar70: folds 
SenQQu: folds 
AlyCWB: folds 
modraa: folds 
Uncalled bet (154732) returned to tasty25
*** FLOP *** [Jc 8h Jd]
*** TURN *** [Jc 8h Jd] [4h]
*** RIVER *** [Jc 8h Jd 4h] [8d]
*** SHOW DOWN ***
pvjach: shows [Tc Th] (two pair, Jacks and Tens)
tasty25: shows [Qd As] (two pair, Jacks and Eights)
pvjach collected 545360 from pot
*** SUMMARY ***
Total pot 545360 | Rake 0 
Board [Jc 8h Jd 4h 8d]
Seat 1: manoel2007 folded before Flop (didn't bet)
Seat 2: llucaschaves folded before Flop (didn't bet)
Seat 3: modraa folded before Flop
Seat 4: pvjach showed [Tc Th] and won (545360) with two pair, Jacks and Tens
Seat 5: tasty25 showed [Qd As] and lost with two pair, Jacks and Eights
Seat 6: tatastar70 (button) folded before Flop (didn't bet)
Seat 7: SenQQu (small blind) folded before Flop
Seat 8: AlyCWB (big blind) folded before Flop
Seat 9: DRONIQQ folded before Flop (didn't bet)



PokerStars Hand #201888716721: Tournament #2634449693, $0.98+$0.12 USD Hold'em No Limit - Level XXVII (17500/35000) - 2019/06/30 18:44:21 BRT [2019/06/30 17:44:21 ET]
Table '2634449693 136' 9-max Seat #7 is the button
Seat 1: manoel2007 (490012 in chips) 
Seat 2: llucaschaves (474094 in chips) 
Seat 3: modraa (1315227 in chips) 
Seat 4: pvjach (545360 in chips) 
Seat 5: tasty25 (154732 in chips) 
Seat 6: tatastar70 (386090 in chips) 
Seat 7: SenQQu (183788 in chips) 
Seat 8: AlyCWB (624911 in chips) 
Seat 9: DRONIQQ (231892 in chips) 
manoel2007: posts the ante 3500
llucaschaves: posts the ante 3500
modraa: posts the ante 3500
pvjach: posts the ante 3500
tasty25: posts the ante 3500
tatastar70: posts the ante 3500
SenQQu: posts the ante 3500
AlyCWB: posts the ante 3500
DRONIQQ: posts the ante 3500
AlyCWB: posts small blind 17500
DRONIQQ: posts big blind 35000
*** HOLE CARDS ***
Dealt to AlyCWB [7d 4h]
manoel2007: folds 
llucaschaves: folds 
modraa: folds 
pvjach: folds 
tasty25: folds 
tatastar70: folds 
SenQQu: raises 145288 to 180288 and is all-in
AlyCWB: folds 
DRONIQQ: folds 
Uncalled bet (145288) returned to SenQQu
SenQQu collected 119000 from pot
*** SUMMARY ***
Total pot 119000 | Rake 0 
Seat 1: manoel2007 folded before Flop (didn't bet)
Seat 2: llucaschaves folded before Flop (didn't bet)
Seat 3: modraa folded before Flop (didn't bet)
Seat 4: pvjach folded before Flop (didn't bet)
Seat 5: tasty25 folded before Flop (didn't bet)
Seat 6: tatastar70 folded before Flop (didn't bet)
Seat 7: SenQQu (button) collected (119000)
Seat 8: AlyCWB (small blind) folded before Flop
Seat 9: DRONIQQ (big blind) folded before Flop



PokerStars Hand #201888726744: Tournament #2634449693, $0.98+$0.12 USD Hold'em No Limit - Level XXVII (17500/35000) - 2019/06/30 18:44:37 BRT [2019/06/30 17:44:37 ET]
Table '2634449693 136' 9-max Seat #8 is the button
Seat 1: manoel2007 (486512 in chips) 
Seat 2: llucaschaves (470594 in chips) 
Seat 3: modraa (1311727 in chips) 
Seat 4: pvjach (541860 in chips) 
Seat 5: tasty25 (151232 in chips) 
Seat 6: tatastar70 (382590 in chips) 
Seat 7: SenQQu (264288 in chips) 
Seat 8: AlyCWB (603911 in chips) 
Seat 9: DRONIQQ (193392 in chips) 
manoel2007: posts the ante 3500
llucaschaves: posts the ante 3500
modraa: posts the ante 3500
pvjach: posts the ante 3500
tasty25: posts the ante 3500
tatastar70: posts the ante 3500
SenQQu: posts the ante 3500
AlyCWB: posts the ante 3500
DRONIQQ: posts the ante 3500
DRONIQQ: posts small blind 17500
manoel2007: posts big blind 35000
*** HOLE CARDS ***
Dealt to AlyCWB [Kd 5d]
llucaschaves: folds 
modraa: folds 
pvjach: folds 
tasty25: folds 
tatastar70: folds 
SenQQu: raises 225788 to 260788 and is all-in
AlyCWB: folds 
DRONIQQ: folds 
manoel2007: folds 
Uncalled bet (225788) returned to SenQQu
SenQQu collected 119000 from pot
*** SUMMARY ***
Total pot 119000 | Rake 0 
Seat 1: manoel2007 (big blind) folded before Flop
Seat 2: llucaschaves folded before Flop (didn't bet)
Seat 3: modraa folded before Flop (didn't bet)
Seat 4: pvjach folded before Flop (didn't bet)
Seat 5: tasty25 folded before Flop (didn't bet)
Seat 6: tatastar70 folded before Flop (didn't bet)
Seat 7: SenQQu collected (119000)
Seat 8: AlyCWB (button) folded before Flop (didn't bet)
Seat 9: DRONIQQ (small blind) folded before Flop



PokerStars Hand #201888741833: Tournament #2634449693, $0.98+$0.12 USD Hold'em No Limit - Level XXVIII (20000/40000) - 2019/06/30 18:45:02 BRT [2019/06/30 17:45:02 ET]
Table '2634449693 136' 9-max Seat #9 is the button
Seat 1: manoel2007 (448012 in chips) 
Seat 2: llucaschaves (467094 in chips) 
Seat 3: modraa (1308227 in chips) 
Seat 4: pvjach (538360 in chips) 
Seat 5: tasty25 (147732 in chips) 
Seat 6: tatastar70 (379090 in chips) 
Seat 7: SenQQu (344788 in chips) 
Seat 8: AlyCWB (600411 in chips) 
Seat 9: DRONIQQ (172392 in chips) 
manoel2007: posts the ante 4000
llucaschaves: posts the ante 4000
modraa: posts the ante 4000
pvjach: posts the ante 4000
tasty25: posts the ante 4000
tatastar70: posts the ante 4000
SenQQu: posts the ante 4000
AlyCWB: posts the ante 4000
DRONIQQ: posts the ante 4000
manoel2007: posts small blind 20000
llucaschaves: posts big blind 40000
*** HOLE CARDS ***
Dealt to AlyCWB [Ts Qs]
modraa: folds 
pvjach: folds 
tasty25: folds 
tatastar70: folds 
SenQQu: raises 300788 to 340788 and is all-in
AlyCWB: folds 
DRONIQQ: folds 
manoel2007: folds 
llucaschaves: folds 
Uncalled bet (300788) returned to SenQQu
SenQQu collected 136000 from pot
*** SUMMARY ***
Total pot 136000 | Rake 0 
Seat 1: manoel2007 (small blind) folded before Flop
Seat 2: llucaschaves (big blind) folded before Flop
Seat 3: modraa folded before Flop (didn't bet)
Seat 4: pvjach folded before Flop (didn't bet)
Seat 5: tasty25 folded before Flop (didn't bet)
Seat 6: tatastar70 folded before Flop (didn't bet)
Seat 7: SenQQu collected (136000)
Seat 8: AlyCWB folded before Flop (didn't bet)
Seat 9: DRONIQQ (button) folded before Flop (didn't bet)



PokerStars Hand #201888771117: Tournament #2634449693, $0.98+$0.12 USD Hold'em No Limit - Level XXVIII (20000/40000) - 2019/06/30 18:45:49 BRT [2019/06/30 17:45:49 ET]
Table '2634449693 136' 9-max Seat #1 is the button
Seat 1: manoel2007 (424012 in chips) 
Seat 2: llucaschaves (423094 in chips) 
Seat 3: modraa (1304227 in chips) 
Seat 4: pvjach (534360 in chips) 
Seat 5: tasty25 (143732 in chips) 
Seat 6: tatastar70 (375090 in chips) 
Seat 7: SenQQu (436788 in chips) 
Seat 8: AlyCWB (596411 in chips) 
Seat 9: DRONIQQ (168392 in chips) 
manoel2007: posts the ante 4000
llucaschaves: posts the ante 4000
modraa: posts the ante 4000
pvjach: posts the ante 4000
tasty25: posts the ante 4000
tatastar70: posts the ante 4000
SenQQu: posts the ante 4000
AlyCWB: posts the ante 4000
DRONIQQ: posts the ante 4000
llucaschaves: posts small blind 20000
modraa: posts big blind 40000
*** HOLE CARDS ***
Dealt to AlyCWB [Jd 2h]
pvjach: folds 
tasty25: folds 
tatastar70: raises 280000 to 320000
SenQQu: folds 
AlyCWB: folds 
DRONIQQ: folds 
manoel2007: folds 
llucaschaves: folds 
modraa: folds 
Uncalled bet (280000) returned to tatastar70
tatastar70 collected 136000 from pot
*** SUMMARY ***
Total pot 136000 | Rake 0 
Seat 1: manoel2007 (button) folded before Flop (didn't bet)
Seat 2: llucaschaves (small blind) folded before Flop
Seat 3: modraa (big blind) folded before Flop
Seat 4: pvjach folded before Flop (didn't bet)
Seat 5: tasty25 folded before Flop (didn't bet)
Seat 6: tatastar70 collected (136000)
Seat 7: SenQQu folded before Flop (didn't bet)
Seat 8: AlyCWB folded before Flop (didn't bet)
Seat 9: DRONIQQ folded before Flop (didn't bet)



PokerStars Hand #201888785550: Tournament #2634449693, $0.98+$0.12 USD Hold'em No Limit - Level XXVIII (20000/40000) - 2019/06/30 18:46:12 BRT [2019/06/30 17:46:12 ET]
Table '2634449693 136' 9-max Seat #2 is the button
Seat 1: manoel2007 (420012 in chips) 
Seat 2: llucaschaves (399094 in chips) 
Seat 3: modraa (1260227 in chips) 
Seat 4: pvjach (530360 in chips) 
Seat 5: tasty25 (139732 in chips) 
Seat 6: tatastar70 (467090 in chips) 
Seat 7: SenQQu (432788 in chips) 
Seat 8: AlyCWB (592411 in chips) 
Seat 9: DRONIQQ (164392 in chips) 
manoel2007: posts the ante 4000
llucaschaves: posts the ante 4000
modraa: posts the ante 4000
pvjach: posts the ante 4000
tasty25: posts the ante 4000
tatastar70: posts the ante 4000
SenQQu: posts the ante 4000
AlyCWB: posts the ante 4000
DRONIQQ: posts the ante 4000
modraa: posts small blind 20000
pvjach: posts big blind 40000
*** HOLE CARDS ***
Dealt to AlyCWB [Th 5c]
tasty25: folds 
tatastar70: raises 60000 to 100000
SenQQu: folds 
AlyCWB: folds 
DRONIQQ: folds 
manoel2007: folds 
llucaschaves: folds 
modraa: folds 
pvjach: folds 
Uncalled bet (60000) returned to tatastar70
tatastar70 collected 136000 from pot
*** SUMMARY ***
Total pot 136000 | Rake 0 
Seat 1: manoel2007 folded before Flop (didn't bet)
Seat 2: llucaschaves (button) folded before Flop (didn't bet)
Seat 3: modraa (small blind) folded before Flop
Seat 4: pvjach (big blind) folded before Flop
Seat 5: tasty25 folded before Flop (didn't bet)
Seat 6: tatastar70 collected (136000)
Seat 7: SenQQu folded before Flop (didn't bet)
Seat 8: AlyCWB folded before Flop (didn't bet)
Seat 9: DRONIQQ folded before Flop (didn't bet)



PokerStars Hand #201888796590: Tournament #2634449693, $0.98+$0.12 USD Hold'em No Limit - Level XXVIII (20000/40000) - 2019/06/30 18:46:30 BRT [2019/06/30 17:46:30 ET]
Table '2634449693 136' 9-max Seat #3 is the button
Seat 1: manoel2007 (416012 in chips) 
Seat 2: llucaschaves (395094 in chips) 
Seat 3: modraa (1236227 in chips) 
Seat 4: pvjach (486360 in chips) 
Seat 5: tasty25 (135732 in chips) 
Seat 6: tatastar70 (559090 in chips) 
Seat 7: SenQQu (428788 in chips) 
Seat 8: AlyCWB (588411 in chips) 
Seat 9: DRONIQQ (160392 in chips) 
manoel2007: posts the ante 4000
llucaschaves: posts the ante 4000
modraa: posts the ante 4000
pvjach: posts the ante 4000
tasty25: posts the ante 4000
tatastar70: posts the ante 4000
SenQQu: posts the ante 4000
AlyCWB: posts the ante 4000
DRONIQQ: posts the ante 4000
pvjach: posts small blind 20000
tasty25: posts big blind 40000
*** HOLE CARDS ***
Dealt to AlyCWB [5c 5h]
tatastar70: folds 
SenQQu: folds 
AlyCWB: raises 40000 to 80000
DRONIQQ: folds 
manoel2007: folds 
llucaschaves: folds 
modraa: folds 
pvjach: folds 
tasty25: calls 40000
*** FLOP *** [2d 3c Qd]
tasty25: checks 
AlyCWB: bets 80000
tasty25: folds 
Uncalled bet (80000) returned to AlyCWB
AlyCWB collected 216000 from pot
*** SUMMARY ***
Total pot 216000 | Rake 0 
Board [2d 3c Qd]
Seat 1: manoel2007 folded before Flop (didn't bet)
Seat 2: llucaschaves folded before Flop (didn't bet)
Seat 3: modraa (button) folded before Flop (didn't bet)
Seat 4: pvjach (small blind) folded before Flop
Seat 5: tasty25 (big blind) folded on the Flop
Seat 6: tatastar70 folded before Flop (didn't bet)
Seat 7: SenQQu folded before Flop (didn't bet)
Seat 8: AlyCWB collected (216000)
Seat 9: DRONIQQ folded before Flop (didn't bet)



PokerStars Hand #201888821457: Tournament #2634449693, $0.98+$0.12 USD Hold'em No Limit - Level XXVIII (20000/40000) - 2019/06/30 18:47:11 BRT [2019/06/30 17:47:11 ET]
Table '2634449693 136' 9-max Seat #4 is the button
Seat 1: manoel2007 (412012 in chips) 
Seat 2: llucaschaves (391094 in chips) 
Seat 3: modraa (1232227 in chips) 
Seat 4: pvjach (462360 in chips) 
Seat 5: tasty25 (51732 in chips) 
Seat 6: tatastar70 (555090 in chips) 
Seat 7: SenQQu (424788 in chips) 
Seat 8: AlyCWB (720411 in chips) 
Seat 9: DRONIQQ (156392 in chips) 
manoel2007: posts the ante 4000
llucaschaves: posts the ante 4000
modraa: posts the ante 4000
pvjach: posts the ante 4000
tasty25: posts the ante 4000
tatastar70: posts the ante 4000
SenQQu: posts the ante 4000
AlyCWB: posts the ante 4000
DRONIQQ: posts the ante 4000
tasty25: posts small blind 20000
tatastar70: posts big blind 40000
*** HOLE CARDS ***
Dealt to AlyCWB [5s Qd]
SenQQu: folds 
AlyCWB: folds 
DRONIQQ: raises 112392 to 152392 and is all-in
manoel2007: folds 
llucaschaves: raises 234702 to 387094 and is all-in
modraa: folds 
pvjach: folds 
tasty25: folds 
tatastar70: folds 
Uncalled bet (234702) returned to llucaschaves
*** FLOP *** [Qs 6h Ts]
*** TURN *** [Qs 6h Ts] [8c]
*** RIVER *** [Qs 6h Ts 8c] [2s]
*** SHOW DOWN ***
DRONIQQ: shows [7c 7h] (a pair of Sevens)
llucaschaves: shows [Ah Qh] (a pair of Queens)
llucaschaves collected 400784 from pot
DRONIQQ finished the tournament in 197th place and received $3.73.
*** SUMMARY ***
Total pot 400784 | Rake 0 
Board [Qs 6h Ts 8c 2s]
Seat 1: manoel2007 folded before Flop (didn't bet)
Seat 2: llucaschaves showed [Ah Qh] and won (400784) with a pair of Queens
Seat 3: modraa folded before Flop (didn't bet)
Seat 4: pvjach (button) folded before Flop (didn't bet)
Seat 5: tasty25 (small blind) folded before Flop
Seat 6: tatastar70 (big blind) folded before Flop
Seat 7: SenQQu folded before Flop (didn't bet)
Seat 8: AlyCWB folded before Flop (didn't bet)
Seat 9: DRONIQQ showed [7c 7h] and lost with a pair of Sevens



PokerStars Hand #201888840309: Tournament #2634449693, $0.98+$0.12 USD Hold'em No Limit - Level XXVIII (20000/40000) - 2019/06/30 18:47:41 BRT [2019/06/30 17:47:41 ET]
Table '2634449693 136' 9-max Seat #5 is the button
Seat 1: manoel2007 (408012 in chips) 
Seat 2: llucaschaves (635486 in chips) 
Seat 3: modraa (1228227 in chips) 
Seat 4: pvjach (458360 in chips) 
Seat 5: tasty25 (27732 in chips) 
Seat 6: tatastar70 (511090 in chips) 
Seat 7: SenQQu (420788 in chips) 
Seat 8: AlyCWB (716411 in chips) 
manoel2007: posts the ante 4000
llucaschaves: posts the ante 4000
modraa: posts the ante 4000
pvjach: posts the ante 4000
tasty25: posts the ante 4000
tatastar70: posts the ante 4000
SenQQu: posts the ante 4000
AlyCWB: posts the ante 4000
tatastar70: posts small blind 20000
SenQQu: posts big blind 40000
*** HOLE CARDS ***
Dealt to AlyCWB [5s 7h]
AlyCWB: folds 
manoel2007: folds 
llucaschaves: raises 40000 to 80000
modraa: folds 
pvjach: folds 
tasty25: folds 
tatastar70: folds 
SenQQu: calls 40000
*** FLOP *** [2d 4h Kd]
SenQQu: bets 336788 and is all-in
llucaschaves: calls 336788
*** TURN *** [2d 4h Kd] [Tc]
*** RIVER *** [2d 4h Kd Tc] [8h]
*** SHOW DOWN ***
SenQQu: shows [4c Jc] (a pair of Fours)
llucaschaves: shows [9d 9s] (a pair of Nines)
llucaschaves collected 885576 from pot
SenQQu finished the tournament in 190th place and received $3.73.
*** SUMMARY ***
Total pot 885576 | Rake 0 
Board [2d 4h Kd Tc 8h]
Seat 1: manoel2007 folded before Flop (didn't bet)
Seat 2: llucaschaves showed [9d 9s] and won (885576) with a pair of Nines
Seat 3: modraa folded before Flop (didn't bet)
Seat 4: pvjach folded before Flop (didn't bet)
Seat 5: tasty25 (button) folded before Flop (didn't bet)
Seat 6: tatastar70 (small blind) folded before Flop
Seat 7: SenQQu (big blind) showed [4c Jc] and lost with a pair of Fours
Seat 8: AlyCWB folded before Flop (didn't bet)



PokerStars Hand #201888903833: Tournament #2634449693, $0.98+$0.12 USD Hold'em No Limit - Level XXVIII (20000/40000) - 2019/06/30 18:49:11 BRT [2019/06/30 17:49:11 ET]
Table '2634449693 145' 9-max Seat #5 is the button
Seat 1: Sanek507 (300387 in chips) 
Seat 2: rgvaz85 (109900 in chips) 
Seat 3: nadisek (577018 in chips) 
Seat 4: AlyCWB (712411 in chips) 
Seat 5: danielwarwar (510824 in chips) 
Seat 6: UANikolay (202540 in chips) 
Seat 7: BrunoV Bueno (484913 in chips) 
Seat 8: gordiness90 (1432275 in chips) 
Seat 9: AokiJrBr (2542301 in chips) 
Sanek507: posts the ante 4000
rgvaz85: posts the ante 4000
nadisek: posts the ante 4000
AlyCWB: posts the ante 4000
danielwarwar: posts the ante 4000
UANikolay: posts the ante 4000
BrunoV Bueno: posts the ante 4000
gordiness90: posts the ante 4000
AokiJrBr: posts the ante 4000
UANikolay: posts small blind 20000
BrunoV Bueno: posts big blind 40000
*** HOLE CARDS ***
Dealt to AlyCWB [3h As]
gordiness90: raises 40000 to 80000
AokiJrBr: folds 
Sanek507: folds 
rgvaz85: folds 
nadisek: folds 
AlyCWB: folds 
danielwarwar: folds 
UANikolay: folds 
BrunoV Bueno: calls 40000
*** FLOP *** [6s 2h 2c]
BrunoV Bueno: checks 
gordiness90: bets 166320
BrunoV Bueno: folds 
Uncalled bet (166320) returned to gordiness90
gordiness90 collected 216000 from pot
*** SUMMARY ***
Total pot 216000 | Rake 0 
Board [6s 2h 2c]
Seat 1: Sanek507 folded before Flop (didn't bet)
Seat 2: rgvaz85 folded before Flop (didn't bet)
Seat 3: nadisek folded before Flop (didn't bet)
Seat 4: AlyCWB folded before Flop (didn't bet)
Seat 5: danielwarwar (button) folded before Flop (didn't bet)
Seat 6: UANikolay (small blind) folded before Flop
Seat 7: BrunoV Bueno (big blind) folded on the Flop
Seat 8: gordiness90 collected (216000)
Seat 9: AokiJrBr folded before Flop (didn't bet)



PokerStars Hand #201888948122: Tournament #2634449693, $0.98+$0.12 USD Hold'em No Limit - Level XXIX (25000/50000) - 2019/06/30 18:50:24 BRT [2019/06/30 17:50:24 ET]
Table '2634449693 145' 9-max Seat #6 is the button
Seat 1: Sanek507 (296387 in chips) 
Seat 2: rgvaz85 (105900 in chips) 
Seat 3: nadisek (573018 in chips) 
Seat 4: AlyCWB (708411 in chips) 
Seat 5: danielwarwar (506824 in chips) 
Seat 6: UANikolay (178540 in chips) 
Seat 7: BrunoV Bueno (400913 in chips) 
Seat 8: gordiness90 (1564275 in chips) 
Seat 9: AokiJrBr (2538301 in chips) 
Sanek507: posts the ante 5000
rgvaz85: posts the ante 5000
nadisek: posts the ante 5000
AlyCWB: posts the ante 5000
danielwarwar: posts the ante 5000
UANikolay: posts the ante 5000
BrunoV Bueno: posts the ante 5000
gordiness90: posts the ante 5000
AokiJrBr: posts the ante 5000
BrunoV Bueno: posts small blind 25000
gordiness90: posts big blind 50000
*** HOLE CARDS ***
Dealt to AlyCWB [As Ah]
AokiJrBr: raises 50000 to 100000
Sanek507: folds 
rgvaz85: folds 
nadisek: folds 
AlyCWB: raises 200000 to 300000
danielwarwar: folds 
UANikolay: folds 
BrunoV Bueno: raises 95913 to 395913 and is all-in
gordiness90: folds 
AokiJrBr: folds 
AlyCWB: calls 95913
*** FLOP *** [2s 6d Ks]
*** TURN *** [2s 6d Ks] [8s]
*** RIVER *** [2s 6d Ks 8s] [4h]
*** SHOW DOWN ***
BrunoV Bueno: shows [9h 9d] (a pair of Nines)
AlyCWB: shows [As Ah] (a pair of Aces)
AlyCWB collected 986826 from pot
BrunoV Bueno finished the tournament in 175th place and received $3.73.
*** SUMMARY ***
Total pot 986826 | Rake 0 
Board [2s 6d Ks 8s 4h]
Seat 1: Sanek507 folded before Flop (didn't bet)
Seat 2: rgvaz85 folded before Flop (didn't bet)
Seat 3: nadisek folded before Flop (didn't bet)
Seat 4: AlyCWB showed [As Ah] and won (986826) with a pair of Aces
Seat 5: danielwarwar folded before Flop (didn't bet)
Seat 6: UANikolay (button) folded before Flop (didn't bet)
Seat 7: BrunoV Bueno (small blind) showed [9h 9d] and lost with a pair of Nines
Seat 8: gordiness90 (big blind) folded before Flop
Seat 9: AokiJrBr folded before Flop



PokerStars Hand #201888977161: Tournament #2634449693, $0.98+$0.12 USD Hold'em No Limit - Level XXIX (25000/50000) - 2019/06/30 18:51:13 BRT [2019/06/30 17:51:13 ET]
Table '2634449693 145' 9-max Seat #8 is the button
Seat 1: Sanek507 (291387 in chips) 
Seat 2: rgvaz85 (100900 in chips) 
Seat 3: nadisek (568018 in chips) 
Seat 4: AlyCWB (1294324 in chips) 
Seat 5: danielwarwar (501824 in chips) 
Seat 6: UANikolay (173540 in chips) 
Seat 8: gordiness90 (1509275 in chips) 
Seat 9: AokiJrBr (2433301 in chips) 
Sanek507: posts the ante 5000
rgvaz85: posts the ante 5000
nadisek: posts the ante 5000
AlyCWB: posts the ante 5000
danielwarwar: posts the ante 5000
UANikolay: posts the ante 5000
gordiness90: posts the ante 5000
AokiJrBr: posts the ante 5000
AokiJrBr: posts small blind 25000
Sanek507: posts big blind 50000
*** HOLE CARDS ***
Dealt to AlyCWB [7s Jc]
rgvaz85: raises 45900 to 95900 and is all-in
nadisek: folds 
AlyCWB: folds 
danielwarwar: folds 
UANikolay: raises 72640 to 168540 and is all-in
gordiness90: folds 
AokiJrBr: raises 147460 to 316000
Sanek507: folds 
Uncalled bet (147460) returned to AokiJrBr
*** FLOP *** [Kd Th 3s]
*** TURN *** [Kd Th 3s] [6d]
*** RIVER *** [Kd Th 3s 6d] [3h]
*** SHOW DOWN ***
AokiJrBr: shows [9d Ah] (a pair of Threes)
UANikolay: shows [As Tc] (two pair, Tens and Threes)
UANikolay collected 145280 from side pot
rgvaz85: shows [9h 6h] (two pair, Sixes and Threes)
UANikolay collected 377700 from main pot
rgvaz85 finished the tournament in 169th place and received $3.73.
*** SUMMARY ***
Total pot 522980 Main pot 377700. Side pot 145280. | Rake 0 
Board [Kd Th 3s 6d 3h]
Seat 1: Sanek507 (big blind) folded before Flop
Seat 2: rgvaz85 showed [9h 6h] and lost with two pair, Sixes and Threes
Seat 3: nadisek folded before Flop (didn't bet)
Seat 4: AlyCWB folded before Flop (didn't bet)
Seat 5: danielwarwar folded before Flop (didn't bet)
Seat 6: UANikolay showed [As Tc] and won (522980) with two pair, Tens and Threes
Seat 8: gordiness90 (button) folded before Flop (didn't bet)
Seat 9: AokiJrBr (small blind) showed [9d Ah] and lost with a pair of Threes



PokerStars Hand #201889019056: Tournament #2634449693, $0.98+$0.12 USD Hold'em No Limit - Level XXIX (25000/50000) - 2019/06/30 18:52:23 BRT [2019/06/30 17:52:23 ET]
Table '2634449693 145' 9-max Seat #9 is the button
Seat 1: Sanek507 (236387 in chips) 
Seat 3: nadisek (563018 in chips) 
Seat 4: AlyCWB (1289324 in chips) 
Seat 5: danielwarwar (496824 in chips) 
Seat 6: UANikolay (522980 in chips) 
Seat 7: BrunoHermann (2095303 in chips) 
Seat 8: gordiness90 (1504275 in chips) 
Seat 9: AokiJrBr (2259761 in chips) 
Sanek507: posts the ante 5000
nadisek: posts the ante 5000
AlyCWB: posts the ante 5000
danielwarwar: posts the ante 5000
UANikolay: posts the ante 5000
BrunoHermann: posts the ante 5000
gordiness90: posts the ante 5000
AokiJrBr: posts the ante 5000
Sanek507: posts small blind 25000
nadisek: posts big blind 50000
*** HOLE CARDS ***
Dealt to AlyCWB [4c 9c]
AlyCWB: folds 
danielwarwar: raises 441824 to 491824 and is all-in
UANikolay: folds 
BrunoHermann: folds 
gordiness90: folds 
AokiJrBr: folds 
Sanek507: folds 
nadisek: folds 
Uncalled bet (441824) returned to danielwarwar
danielwarwar collected 165000 from pot
danielwarwar: doesn't show hand 
*** SUMMARY ***
Total pot 165000 | Rake 0 
Seat 1: Sanek507 (small blind) folded before Flop
Seat 3: nadisek (big blind) folded before Flop
Seat 4: AlyCWB folded before Flop (didn't bet)
Seat 5: danielwarwar collected (165000)
Seat 6: UANikolay folded before Flop (didn't bet)
Seat 7: BrunoHermann folded before Flop (didn't bet)
Seat 8: gordiness90 folded before Flop (didn't bet)
Seat 9: AokiJrBr (button) folded before Flop (didn't bet)



PokerStars Hand #201889031699: Tournament #2634449693, $0.98+$0.12 USD Hold'em No Limit - Level XXIX (25000/50000) - 2019/06/30 18:52:44 BRT [2019/06/30 17:52:44 ET]
Table '2634449693 145' 9-max Seat #1 is the button
Seat 1: Sanek507 (206387 in chips) 
Seat 3: nadisek (508018 in chips) 
Seat 4: AlyCWB (1284324 in chips) 
Seat 5: danielwarwar (606824 in chips) 
Seat 6: UANikolay (517980 in chips) 
Seat 7: BrunoHermann (2090303 in chips) 
Seat 8: gordiness90 (1499275 in chips) 
Seat 9: AokiJrBr (2254761 in chips) 
Sanek507: posts the ante 5000
nadisek: posts the ante 5000
AlyCWB: posts the ante 5000
danielwarwar: posts the ante 5000
UANikolay: posts the ante 5000
BrunoHermann: posts the ante 5000
gordiness90: posts the ante 5000
AokiJrBr: posts the ante 5000
nadisek: posts small blind 25000
AlyCWB: posts big blind 50000
*** HOLE CARDS ***
Dealt to AlyCWB [7h Ks]
danielwarwar: folds 
UANikolay: folds 
BrunoHermann: folds 
gordiness90: raises 50000 to 100000
AokiJrBr: folds 
Sanek507: folds 
nadisek: folds 
AlyCWB: folds 
Uncalled bet (50000) returned to gordiness90
gordiness90 collected 165000 from pot
gordiness90: doesn't show hand 
*** SUMMARY ***
Total pot 165000 | Rake 0 
Seat 1: Sanek507 (button) folded before Flop (didn't bet)
Seat 3: nadisek (small blind) folded before Flop
Seat 4: AlyCWB (big blind) folded before Flop
Seat 5: danielwarwar folded before Flop (didn't bet)
Seat 6: UANikolay folded before Flop (didn't bet)
Seat 7: BrunoHermann folded before Flop (didn't bet)
Seat 8: gordiness90 collected (165000)
Seat 9: AokiJrBr folded before Flop (didn't bet)



PokerStars Hand #201889049239: Tournament #2634449693, $0.98+$0.12 USD Hold'em No Limit - Level XXIX (25000/50000) - 2019/06/30 18:53:14 BRT [2019/06/30 17:53:14 ET]
Table '2634449693 145' 9-max Seat #3 is the button
Seat 1: Sanek507 (201387 in chips) 
Seat 3: nadisek (478018 in chips) 
Seat 4: AlyCWB (1229324 in chips) 
Seat 5: danielwarwar (601824 in chips) 
Seat 6: UANikolay (512980 in chips) 
Seat 7: BrunoHermann (2085303 in chips) 
Seat 8: gordiness90 (1609275 in chips) 
Seat 9: AokiJrBr (2249761 in chips) 
Sanek507: posts the ante 5000
nadisek: posts the ante 5000
AlyCWB: posts the ante 5000
danielwarwar: posts the ante 5000
UANikolay: posts the ante 5000
BrunoHermann: posts the ante 5000
gordiness90: posts the ante 5000
AokiJrBr: posts the ante 5000
AlyCWB: posts small blind 25000
danielwarwar: posts big blind 50000
*** HOLE CARDS ***
Dealt to AlyCWB [Ah Qc]
UANikolay: folds 
BrunoHermann: folds 
gordiness90: folds 
AokiJrBr: folds 
Sanek507: raises 146387 to 196387 and is all-in
nadisek: calls 196387
AlyCWB: raises 1027937 to 1224324 and is all-in
danielwarwar: folds 
nadisek: calls 276631 and is all-in
Uncalled bet (751306) returned to AlyCWB
*** FLOP *** [3d Qh 5h]
*** TURN *** [3d Qh 5h] [2d]
*** RIVER *** [3d Qh 5h 2d] [Jc]
*** SHOW DOWN ***
AlyCWB: shows [Ah Qc] (a pair of Queens)
nadisek: shows [Qs Jh] (two pair, Queens and Jacks)
nadisek collected 553262 from side pot
Sanek507: shows [Kh 9d] (high card King)
nadisek collected 679161 from main pot
Sanek507 finished the tournament in 160th place and received $3.73.
*** SUMMARY ***
Total pot 1232423 Main pot 679161. Side pot 553262. | Rake 0 
Board [3d Qh 5h 2d Jc]
Seat 1: Sanek507 showed [Kh 9d] and lost with high card King
Seat 3: nadisek (button) showed [Qs Jh] and won (1232423) with two pair, Queens and Jacks
Seat 4: AlyCWB (small blind) showed [Ah Qc] and lost with a pair of Queens
Seat 5: danielwarwar (big blind) folded before Flop
Seat 6: UANikolay folded before Flop (didn't bet)
Seat 7: BrunoHermann folded before Flop (didn't bet)
Seat 8: gordiness90 folded before Flop (didn't bet)
Seat 9: AokiJrBr folded before Flop (didn't bet)



PokerStars Hand #201889071986: Tournament #2634449693, $0.98+$0.12 USD Hold'em No Limit - Level XXIX (25000/50000) - 2019/06/30 18:53:52 BRT [2019/06/30 17:53:52 ET]
Table '2634449693 145' 9-max Seat #4 is the button
Seat 2: dnova1322 (715359 in chips) 
Seat 3: nadisek (1232423 in chips) 
Seat 4: AlyCWB (751306 in chips) 
Seat 5: danielwarwar (546824 in chips) 
Seat 6: UANikolay (507980 in chips) 
Seat 7: BrunoHermann (2080303 in chips) 
Seat 8: gordiness90 (1604275 in chips) 
Seat 9: AokiJrBr (2244761 in chips) 
dnova1322: posts the ante 5000
nadisek: posts the ante 5000
AlyCWB: posts the ante 5000
danielwarwar: posts the ante 5000
UANikolay: posts the ante 5000
BrunoHermann: posts the ante 5000
gordiness90: posts the ante 5000
AokiJrBr: posts the ante 5000
danielwarwar: posts small blind 25000
UANikolay: posts big blind 50000
*** HOLE CARDS ***
Dealt to AlyCWB [Jc 8s]
BrunoHermann: folds 
gordiness90: raises 50000 to 100000
AokiJrBr: folds 
dnova1322: raises 610359 to 710359 and is all-in
nadisek: folds 
AlyCWB: folds 
danielwarwar: folds 
UANikolay: folds 
gordiness90: calls 610359
*** FLOP *** [5c 3c 3d]
*** TURN *** [5c 3c 3d] [9c]
*** RIVER *** [5c 3c 3d 9c] [Jh]
*** SHOW DOWN ***
gordiness90: shows [Ac Kd] (a pair of Threes)
dnova1322: shows [Kh Ah] (a pair of Threes)
gordiness90 collected 767859 from pot
dnova1322 collected 767859 from pot
*** SUMMARY ***
Total pot 1535718 | Rake 0 
Board [5c 3c 3d 9c Jh]
Seat 2: dnova1322 showed [Kh Ah] and won (767859) with a pair of Threes
Seat 3: nadisek folded before Flop (didn't bet)
Seat 4: AlyCWB (button) folded before Flop (didn't bet)
Seat 5: danielwarwar (small blind) folded before Flop
Seat 6: UANikolay (big blind) folded before Flop
Seat 7: BrunoHermann folded before Flop (didn't bet)
Seat 8: gordiness90 showed [Ac Kd] and won (767859) with a pair of Threes
Seat 9: AokiJrBr folded before Flop (didn't bet)



PokerStars Hand #201889108533: Tournament #2634449693, $0.98+$0.12 USD Hold'em No Limit - Level XXX (30000/60000) - 2019/06/30 18:54:55 BRT [2019/06/30 17:54:55 ET]
Table '2634449693 145' 9-max Seat #5 is the button
Seat 1: geor777777 (443880 in chips) 
Seat 2: dnova1322 (767859 in chips) 
Seat 3: nadisek (1227423 in chips) 
Seat 4: AlyCWB (746306 in chips) 
Seat 5: danielwarwar (516824 in chips) 
Seat 6: UANikolay (452980 in chips) 
Seat 7: BrunoHermann (2075303 in chips) 
Seat 8: gordiness90 (1656775 in chips) 
Seat 9: AokiJrBr (2239761 in chips) 
geor777777: posts the ante 6000
dnova1322: posts the ante 6000
nadisek: posts the ante 6000
AlyCWB: posts the ante 6000
danielwarwar: posts the ante 6000
UANikolay: posts the ante 6000
BrunoHermann: posts the ante 6000
gordiness90: posts the ante 6000
AokiJrBr: posts the ante 6000
UANikolay: posts small blind 30000
BrunoHermann: posts big blind 60000
*** HOLE CARDS ***
Dealt to AlyCWB [Ad 9c]
gordiness90: raises 60000 to 120000
AokiJrBr: folds 
geor777777: folds 
dnova1322: folds 
nadisek: folds 
AlyCWB: folds 
danielwarwar: raises 390824 to 510824 and is all-in
UANikolay: folds 
BrunoHermann: folds 
gordiness90: folds 
Uncalled bet (390824) returned to danielwarwar
danielwarwar collected 384000 from pot
danielwarwar: doesn't show hand 
*** SUMMARY ***
Total pot 384000 | Rake 0 
Seat 1: geor777777 folded before Flop (didn't bet)
Seat 2: dnova1322 folded before Flop (didn't bet)
Seat 3: nadisek folded before Flop (didn't bet)
Seat 4: AlyCWB folded before Flop (didn't bet)
Seat 5: danielwarwar (button) collected (384000)
Seat 6: UANikolay (small blind) folded before Flop
Seat 7: BrunoHermann (big blind) folded before Flop
Seat 8: gordiness90 folded before Flop
Seat 9: AokiJrBr folded before Flop (didn't bet)



PokerStars Hand #201889265996: Tournament #2634449693, $0.98+$0.12 USD Hold'em No Limit - Level XXX (30000/60000) - 2019/06/30 19:01:12 BRT [2019/06/30 18:01:12 ET]
Table '2634449693 145' 9-max Seat #6 is the button
Seat 1: geor777777 (437880 in chips) 
Seat 2: dnova1322 (761859 in chips) 
Seat 3: nadisek (1221423 in chips) 
Seat 4: AlyCWB (740306 in chips) 
Seat 5: danielwarwar (774824 in chips) 
Seat 6: UANikolay (416980 in chips) 
Seat 7: BrunoHermann (2009303 in chips) 
Seat 8: gordiness90 (1530775 in chips) 
Seat 9: AokiJrBr (2233761 in chips) 
geor777777: posts the ante 6000
dnova1322: posts the ante 6000
nadisek: posts the ante 6000
AlyCWB: posts the ante 6000
danielwarwar: posts the ante 6000
UANikolay: posts the ante 6000
BrunoHermann: posts the ante 6000
gordiness90: posts the ante 6000
AokiJrBr: posts the ante 6000
BrunoHermann: posts small blind 30000
gordiness90: posts big blind 60000
*** HOLE CARDS ***
Dealt to AlyCWB [7d 3d]
AokiJrBr: folds 
geor777777: folds 
dnova1322: raises 60000 to 120000
nadisek: folds 
AlyCWB: folds 
danielwarwar: folds 
UANikolay: raises 290980 to 410980 and is all-in
BrunoHermann: folds 
gordiness90: raises 1113795 to 1524775 and is all-in
dnova1322: folds 
Uncalled bet (1113795) returned to gordiness90
*** FLOP *** [2d 6h 3c]
*** TURN *** [2d 6h 3c] [5h]
*** RIVER *** [2d 6h 3c 5h] [Ts]
*** SHOW DOWN ***
gordiness90: shows [Jd Jc] (a pair of Jacks)
UANikolay: shows [Ac Ad] (a pair of Aces)
UANikolay collected 1025960 from pot
*** SUMMARY ***
Total pot 1025960 | Rake 0 
Board [2d 6h 3c 5h Ts]
Seat 1: geor777777 folded before Flop (didn't bet)
Seat 2: dnova1322 folded before Flop
Seat 3: nadisek folded before Flop (didn't bet)
Seat 4: AlyCWB folded before Flop (didn't bet)
Seat 5: danielwarwar folded before Flop (didn't bet)
Seat 6: UANikolay (button) showed [Ac Ad] and won (1025960) with a pair of Aces
Seat 7: BrunoHermann (small blind) folded before Flop
Seat 8: gordiness90 (big blind) showed [Jd Jc] and lost with a pair of Jacks
Seat 9: AokiJrBr folded before Flop (didn't bet)



PokerStars Hand #201889303713: Tournament #2634449693, $0.98+$0.12 USD Hold'em No Limit - Level XXX (30000/60000) - 2019/06/30 19:02:24 BRT [2019/06/30 18:02:24 ET]
Table '2634449693 145' 9-max Seat #7 is the button
Seat 1: geor777777 (431880 in chips) 
Seat 2: dnova1322 (635859 in chips) 
Seat 3: nadisek (1215423 in chips) 
Seat 4: AlyCWB (734306 in chips) 
Seat 5: danielwarwar (768824 in chips) 
Seat 6: UANikolay (1025960 in chips) 
Seat 7: BrunoHermann (1973303 in chips) 
Seat 8: gordiness90 (1113795 in chips) 
Seat 9: AokiJrBr (2227761 in chips) 
geor777777: posts the ante 6000
dnova1322: posts the ante 6000
nadisek: posts the ante 6000
AlyCWB: posts the ante 6000
danielwarwar: posts the ante 6000
UANikolay: posts the ante 6000
BrunoHermann: posts the ante 6000
gordiness90: posts the ante 6000
AokiJrBr: posts the ante 6000
gordiness90: posts small blind 30000
AokiJrBr: posts big blind 60000
*** HOLE CARDS ***
Dealt to AlyCWB [8d 3c]
geor777777: folds 
dnova1322: folds 
nadisek: folds 
AlyCWB: folds 
danielwarwar: folds 
UANikolay: folds 
BrunoHermann: raises 60000 to 120000
gordiness90: folds 
AokiJrBr: calls 60000
*** FLOP *** [2h 2c 8c]
AokiJrBr: checks 
BrunoHermann: bets 1847303 and is all-in
AokiJrBr: folds 
Uncalled bet (1847303) returned to BrunoHermann
BrunoHermann collected 324000 from pot
BrunoHermann: doesn't show hand 
*** SUMMARY ***
Total pot 324000 | Rake 0 
Board [2h 2c 8c]
Seat 1: geor777777 folded before Flop (didn't bet)
Seat 2: dnova1322 folded before Flop (didn't bet)
Seat 3: nadisek folded before Flop (didn't bet)
Seat 4: AlyCWB folded before Flop (didn't bet)
Seat 5: danielwarwar folded before Flop (didn't bet)
Seat 6: UANikolay folded before Flop (didn't bet)
Seat 7: BrunoHermann (button) collected (324000)
Seat 8: gordiness90 (small blind) folded before Flop
Seat 9: AokiJrBr (big blind) folded on the Flop



PokerStars Hand #201889339725: Tournament #2634449693, $0.98+$0.12 USD Hold'em No Limit - Level XXX (30000/60000) - 2019/06/30 19:03:27 BRT [2019/06/30 18:03:27 ET]
Table '2634449693 145' 9-max Seat #8 is the button
Seat 1: geor777777 (425880 in chips) 
Seat 2: dnova1322 (629859 in chips) 
Seat 3: nadisek (1209423 in chips) 
Seat 4: AlyCWB (728306 in chips) 
Seat 5: danielwarwar (762824 in chips) 
Seat 6: UANikolay (1019960 in chips) 
Seat 7: BrunoHermann (2171303 in chips) 
Seat 8: gordiness90 (1077795 in chips) 
Seat 9: AokiJrBr (2101761 in chips) 
geor777777: posts the ante 6000
dnova1322: posts the ante 6000
nadisek: posts the ante 6000
AlyCWB: posts the ante 6000
danielwarwar: posts the ante 6000
UANikolay: posts the ante 6000
BrunoHermann: posts the ante 6000
gordiness90: posts the ante 6000
AokiJrBr: posts the ante 6000
AokiJrBr: posts small blind 30000
geor777777: posts big blind 60000
*** HOLE CARDS ***
Dealt to AlyCWB [Kc Ac]
dnova1322: folds 
nadisek: folds 
AlyCWB: raises 60000 to 120000
danielwarwar: folds 
UANikolay: folds 
BrunoHermann: folds 
gordiness90: folds 
AokiJrBr: raises 900000 to 1020000
geor777777: calls 359880 and is all-in
AlyCWB: calls 602306 and is all-in
Uncalled bet (297694) returned to AokiJrBr
*** FLOP *** [5s 9h 6s]
*** TURN *** [5s 9h 6s] [Qs]
*** RIVER *** [5s 9h 6s Qs] [6h]
*** SHOW DOWN ***
AokiJrBr: shows [5h 5d] (a full house, Fives full of Sixes)
AlyCWB: shows [Kc Ac] (a pair of Sixes)
AokiJrBr collected 604852 from side pot
geor777777: shows [Kd As] (a pair of Sixes)
AokiJrBr collected 1313640 from main pot
AlyCWB finished the tournament in 127th place and received $4.32.
geor777777 finished the tournament in 128th place and received $4.32.
*** SUMMARY ***
Total pot 1918492 Main pot 1313640. Side pot 604852. | Rake 0 
Board [5s 9h 6s Qs 6h]
Seat 1: geor777777 (big blind) showed [Kd As] and lost with a pair of Sixes
Seat 2: dnova1322 folded before Flop (didn't bet)
Seat 3: nadisek folded before Flop (didn't bet)
Seat 4: AlyCWB showed [Kc Ac] and lost with a pair of Sixes
Seat 5: danielwarwar folded before Flop (didn't bet)
Seat 6: UANikolay folded before Flop (didn't bet)
Seat 7: BrunoHermann folded before Flop (didn't bet)
Seat 8: gordiness90 (button) folded before Flop (didn't bet)
Seat 9: AokiJrBr (small blind) showed [5h 5d] and won (1918492) with a full house, Fives full of Sixes



